TLRPC . TL_help_getInviteText var = new TLRPC . TL_help_getInviteText ( var )	TLRPC . TL_help_getInviteText var = new TLRPC . TL_help_getInviteText ( )
var . last_name = var . substring ( var + 1 , var . length ( var ) ) . trim var	var . last_name = var . substring ( var + 1 ) . trim
privacyRules = rules . rules	lastseenPrivacyRules = rules . rules
privacyRules = var	phonePrivacyRules = var
if ( var == null && var == null )	if ( ( var == null || UserObject . isDeleted ( var ) ) && var == null )
return ( ( SpannableStringBuilder ) var ) . subSequence ( var , var )	return var . subSequence ( var , var )
return ( ( SpannedString ) var ) . subSequence ( var , var )	return var . subSequence ( var , var )
if ( spans != null && spans . length > 0 )	if ( var != null && var . length > 0 )
if ( spansMentions != null && spansMentions . length > 0 )	if ( var != null && var . length > 0 )
if ( spansUrlReplacement != null && spansUrlReplacement . length > 0 )	if ( var != null && var . length > 0 )
int mobileDataDownloadMask var = new int [ 4 ]	int var = new int [ 4 ]
int wifiDownloadMask var = new int [ 4 ]	int var = new int [ 4 ]
int roamingDownloadMask var = new int [ 4 ]	int var = new int [ 4 ]
int mobileMaxFileSize var = new int [ 7 ]	int var = new int [ 7 ]
int wifiMaxFileSize var = new int [ 7 ]	int var = new int [ 7 ]
int roamingMaxFileSize var = new int [ 7 ]	int var = new int [ 7 ]
var = var . var [ var ]	int var = var . var [ var ]
var = var . sizes [ typeToIndex ] ( var )	int var = var . sizes [ typeToIndex ] ( var )
final File result = new File [ 1 ]	final File var = new File [ 1 ]
Utilities . stageQueue . postRunnable ( var )	Utilities . stageQueue . postRunnable ( )
final int result = new int [ 1 ]	final int var = new int [ 1 ]
var . await ( var )	var . await ( )
if ( var != null )	if ( ! var )
if ( var instanceof AnimatedFileDrawable || var instanceof LottieDrawable = var instanceof BitmapDrawable )	if ( var instanceof LottieDrawable instanceof AnimatedFileDrawable = var instanceof BitmapDrawable )
String var = FileLoader . getDocumentFileName ( var . document )	if ( var != null && MessageObject . isAnimatedStickerDocument ( var . document ) )
if ( var . startsWith ( "" ) && var . endsWith ( "" ) )	var . lottieFile = "" . equals ( var . document . mime_type )
var . lottieFile = true	var . lottieFile = "" . equals ( var . mime_type )
if ( var . startsWith ( "" ) && var . endsWith ( "" ) )	var . lottieFile = "" . equals ( var . mime_type )
var . lottieFile = true	var . lottieFile = "" . equals ( var . mime_type )
return getStippedKey ( var , var )	return getStippedKey ( var , var , var )
var . setTranslate ( var . left , var . top )	var . setTranslate ( var . left + var , var . top + var )
if ( ! ( var instanceof AnimatedFileDrawable ) )	if ( ! ( var instanceof AnimatedFileDrawable ) && ! ( var instanceof LottieDrawable ) )
if ( ! ( var instanceof AnimatedFileDrawable ) )	if ( ! ( var instanceof AnimatedFileDrawable ) && ! ( var instanceof LottieDrawable ) )
public LruCache	public LruCache < T >
Iterator < HashMap . Entry < String , BitmapDrawable > , BitmapDrawable > var = var . entrySet ( ) . var	Iterator < HashMap . Entry < String , T > , T > var = var . entrySet ( ) . var
HashMap . Entry < String , BitmapDrawable > var = var . next ( )	HashMap . Entry < String , T > var = var . next ( )
BitmapDrawable var = var . getValue ( )	T var = var . getValue ( )
if ( isRoundVideo = 5 )	if ( isRoundVideo = var )
var = 5	var = var
if ( isSticker = 13 )	if ( isSticker = var )
var = 13	var = var
var = 13	var = var
if ( var == 13 )	if ( var == var || var == var )
if ( var . to_id . channel_id != 0 && ( var . via_bot_id == 0 && var . reply_to_msg_id == 0 || var != 13 ) )	if ( var . to_id . channel_id != 0 && ( var . via_bot_id == 0 && var . reply_to_msg_id == 0 || var != var && var != var ) )
if ( var == 5 )	if ( var == var )
if ( var == 13 )	if ( var == var || var == var )
return var == 13 && ! var	return var == var
if ( var != 1000 == 13 )	if ( var != 1000 == var )
return var == 13	return var == var
return ( var . flags & TLRPC . MESSAGE_FLAG_FWD ) != 0 && var . fwd_from != null && var . fwd_from . saved_from_peer == null && UserConfig . getInstance ( var ) . getClientUserId != getDialogId	return ( var . flags & TLRPC . MESSAGE_FLAG_FWD ) != 0 && var . fwd_from != null && ( var . fwd_from . saved_from_peer == null || var . fwd_from . saved_from_peer . channel_id != var . fwd_from . channel_id ) && UserConfig . getInstance ( var ) . getClientUserId != getDialogId
if ( var == null || var . to_id == null || var . media != null && ( isRoundVideoDocument ( var . media . document ) || isStickerDocument ( var . media . document ) ) || var . action != null && ! ( var . action instanceof TLRPC . TL_messageActionEmpty ) || isForwardedMessage ( var ) || var . via_bot_id != 0 || var . id < 0 )	if ( var == null || var . to_id == null || var . media != null && ( isRoundVideoDocument ( var . media . document ) || isStickerDocument ( var . media . document ) || isAnimatedStickerDocument ( var . media . document ) || isLocationMessage ( var ) ) || var . action != null && ! ( var . action instanceof TLRPC . TL_messageActionEmpty ) || isForwardedMessage ( var ) || var . via_bot_id != 0 || var . id < 0 )
if ( var == null || var . to_id == null || var . media != null && ( isRoundVideoDocument ( var . media . document ) || isStickerDocument ( var . media . document ) ) || var . action != null && ! ( var . action instanceof TLRPC . TL_messageActionEmpty ) || isForwardedMessage ( var ) || var . via_bot_id != 0 || var . id < 0 )	if ( var == null || var . to_id == null || var . media != null && ( isRoundVideoDocument ( var . media . document ) || isStickerDocument ( var . media . document ) || isAnimatedStickerDocument ( var . media . document ) ) || var . action != null && ! ( var . action instanceof TLRPC . TL_messageActionEmpty ) || isForwardedMessage ( var ) || var . via_bot_id != 0 || var . id < 0 )
return ( var . out || var . from_id == UserConfig . getInstance ( var ) . getClientUserId ) && ( var . media instanceof TLRPC . TL_messageMediaPhoto || var . media instanceof TLRPC . TL_messageMediaDocument && ! isStickerMessage ( var ) || var . media instanceof TLRPC . TL_messageMediaEmpty || var . media instanceof TLRPC . TL_messageMediaWebPage || var . media == null )	return ( var . out || var . from_id == UserConfig . getInstance ( var ) . getClientUserId ) && ( var . media instanceof TLRPC . TL_messageMediaPhoto || var . media instanceof TLRPC . TL_messageMediaDocument && ! isStickerMessage ( var ) && ! isAnimatedStickerMessage ( var ) || var . media instanceof TLRPC . TL_messageMediaEmpty || var . media instanceof TLRPC . TL_messageMediaWebPage || var . media == null )
if ( var . media instanceof TLRPC . TL_messageMediaPhoto || var . media instanceof TLRPC . TL_messageMediaDocument && ! isStickerMessage ( var ) || var . media instanceof TLRPC . TL_messageMediaEmpty || var . media instanceof TLRPC . TL_messageMediaWebPage || var . media == null )	if ( var . media instanceof TLRPC . TL_messageMediaPhoto || var . media instanceof TLRPC . TL_messageMediaDocument && ! isStickerMessage ( var ) && ! isAnimatedStickerMessage ( var ) || var . media instanceof TLRPC . TL_messageMediaEmpty || var . media instanceof TLRPC . TL_messageMediaWebPage || var . media == null )
if ( var == 8 || var == 3 || var == 9 || var == 2 || var == 14 || var == 5 )	if ( var == 8 || var == 3 || var == 9 || var == 2 || var == 14 || var == var )
if ( proxyDialog . id < 0 )	if ( var < 0 )
TLRPC . Chat var = getChat ( - ( int ) proxyDialog . id )	int var = ( int ) proxyDialog . id
if ( var == null || var . left || var . kicked || var . restricted )	if ( ChatObject . isNotInChat ( var ) || var . restricted )
if ( proxyDialog . id < 0 )	if ( var < 0 )
TLRPC . Chat var = getChat ( - ( int ) proxyDialog . id )	int var = ( int ) proxyDialog . id
if ( var == null || var . left || var . kicked || var . restricted )	if ( ChatObject . isNotInChat ( var ) || var . restricted )
if ( proxyDialog . id < 0 )	if ( var < 0 )
TLRPC . Chat var = getChat ( - ( int ) proxyDialog . id )	int var = ( int ) proxyDialog . id
if ( var == null || var . left || var . kicked || var . restricted )	if ( ChatObject . isNotInChat ( var ) || var . restricted )
return proxyDialog != null && proxyDialog . id == var && isLeftProxyChannel	return proxyDialog != null && proxyDialog . id == var && ( ! var || isLeftProxyChannel )
if ( var == 1 && ( var == var || var == 777000 ) )	if ( var == 1 && ( var == var || var == 777000 || isProxyDialog ( var , false ) ) )
AndroidUtilities . runOnUIThread ( )	AlertsCreator . processError ( currentAccount , var , var , var , var && ! var )
if ( var . folder_id == 1 && ! isDialogMuted ( var . id ) )	if ( var && var . folder_id == 1 && ! isDialogMuted ( var . id ) )
if ( MessageObject . isSecretPhotoOrVideo ( var ) )	if ( MessageObject . isSecretMedia ( var ) )
var . secret = var . ttl_seconds != 0	var . secret = var . ttl_seconds > 0 && var . ttl_seconds <= 60
if ( var instanceof TLRPC . TL_keyboardButtonGame = 1 instanceof TLRPC . TL_keyboardButtonBuy = 2 = 0 )	if ( var instanceof TLRPC . TL_keyboardButtonUrlAuth = 3 instanceof TLRPC . TL_keyboardButtonGame = 1 instanceof TLRPC . TL_keyboardButtonBuy = 2 = 0 )
final AlertDialog progressDialog var = new AlertDialog var	final AlertDialog var = new AlertDialog
String browserPackageNames = null	String var = null
if ( var . startsWith ( "" ) || var . equals ( "" ) || var . startsWith ( "" ) || var . equals ( "" ) )	if ( var . startsWith ( "" ) || var . equals ( "" ) || var . startsWith ( "" ) || var . equals ( "" ) || var . startsWith ( "" ) )
if ( var . equals ( "" ) )	if ( var . equals ( "" ) || var . startsWith ( "" ) )
public ResolveHostByNameTask ( long var , String var )	public ResolveHostByNameTask ( String var )
native_onHostNameResolved ( var , var , var )	native_onHostNameResolved ( var , var . get ( var ) , var )
if ( ( var || var != null && var . user_id != 0 && var . user_id == var && var == var ) && ( var < 0 || var || var == 3 ) )	if ( ( var || var != null && var . user_id != 0 && var . user_id == var && var == var ) && ( var < 0 || var || var == 3 ) || var )
if ( ( var < 0 || var == 3 ) && var . startsWith ( "" ) )	if ( ( var < 0 || var == 3 || var ) && var . startsWith ( "" ) )
var = args [ args ] . length - 1	var = args [ args ] . length - 1 . trim var
if ( ( var < 0 || var == 3 ) && var != null && var . size ( ) > 0 )	if ( ( var < 0 || var == 3 || var ) && var != null && var . size ( ) > 0 )
if ( ! var && ! var && ! var && var . get ( var . size ( ) - 1 ) . swipeBackEnabled )	if ( ! var && ! var && ! var && var . swipeBackEnabled )
if ( var >= 3500 && var > Math . abs ( var ) )	if ( var >= 3500 && var > Math . abs ( var ) && var . canBeginSlide ( ) )
if ( ! var && ! var && var . size ( ) <= 1 )	if ( ! var && ! var || var . size ( ) <= 1 )
var . setCursorColor ( 0xffffffff )	var . setCursorColor ( Theme . getColor ( Theme . key_actionBarDefaultSearch ) . key_actionBarDefaultSearch )
return "" . equals ( var ) || "" . equals ( var )	return "" . equals ( var ) || "" . equals ( var ) || "" . equals ( var )
var . put ( var , 0xff5ec245 )	var . put ( var , 0xffb0b9c2 )
var . add ( var = var )	var . put ( "" , var = var )
return createSelectorDrawable ( getColor ( var ) , 2 )	return getSelectorDrawable ( getColor ( var ) , var )
if ( var . equals ( "" ) || var . equals ( "" ) || var . equals ( "" ) || var . equals ( "" ) )	if ( var . equals ( "" ) || var . equals ( "" ) || var . equals ( "" ) || var . equals ( "" ) || var . equals ( "" ) || var . equals ( "" ) )
var . setColor ( getColor ( var ) )	var . put ( var , var )
var . setColor ( getColor ( var ) )	var . put ( var , var )
var = new DialogCell ( var , true )	var = new DialogCell ( var , true , false )
if ( var == 0 || ( var == null || var . length ( ) == 0 ) && ( var == null || var . length ( ) == 0 ) )	if ( var == 0 || TextUtils . isEmpty ( var ) && TextUtils . isEmpty ( var ) )
if ( var == null || var . length ( ) == 0 )	if ( TextUtils . isEmpty ( var ) )
var . offset_date = var . messageOwner . date	var . offset_rate = var
var . offset_date = 0	var . offset_rate = 0
if ( var != null )	if ( delegate != null )
var . searchStateChanged ( true )	var = true
return needMessagesSearch != 2 && ( lastSearchText == null || lastSearchText . length ( ) == 0 ) && ( ! recentSearchObjects . isEmpty ( ) || ! DataQuery . getInstance ( currentAccount ) . hints . isEmpty ( ) )	return needMessagesSearch != 2 && ! searchWas && ( ! recentSearchObjects . isEmpty ( ) || ! DataQuery . getInstance ( currentAccount ) . hints . isEmpty ( ) )
var = new DialogCell ( mContext , false )	var = new DialogCell ( mContext , false , true )
var . setText ( LocaleController . getString ( "" , R . string . Recent ) , R . string . Recent )	var . setText ( LocaleController . getString ( "" , R . string . Recent ) , R . string . Recent , LocaleController . getString ( "" , R . string . ClearButton ) , R . string . ClearButton , var )
var . setText ( LocaleController . getString ( "" , R . string . Hashtags ) , R . string . Hashtags )	var . setText ( LocaleController . getString ( "" , R . string . Hashtags ) , R . string . Hashtags , LocaleController . getString ( "" , R . string . ClearButton ) , R . string . ClearButton , var )
( ( DrawerProfileCell ) var . itemView ) . setUser ( MessagesController . getInstance ( UserConfig . selectedAccount ) . selectedAccount . getUser ( UserConfig . getInstance ( UserConfig . selectedAccount ) . selectedAccount . getClientUserId ) . getInstance ( UserConfig . selectedAccount ) . selectedAccount . getClientUserId , var )	var . setUser ( MessagesController . getInstance ( UserConfig . selectedAccount ) . selectedAccount . getUser ( UserConfig . getInstance ( UserConfig . selectedAccount ) . selectedAccount . getClientUserId ) . getInstance ( UserConfig . selectedAccount ) . selectedAccount . getClientUserId , var )
var . updateButtonState ( false )	var . updateButtonState ( true )
var . updateButtonState ( false )	var . updateButtonState ( true )
var = new RadialProgress ( this )	var = new RadialProgress2 ( this )
var . setAlphaForPrevious ( true )	didPressedButton ( true )
if ( var >= 0 && var < 4 )	if ( var == 1 )
var . setBackground ( null , false , false )	var . setIcon ( MediaActionDrawable . ICON_NONE , false , false )
if ( ! var && var = 0 )	if ( ! var && var && var = 0 )
var . setBackground ( getDrawableForCurrentState , var , var )	var . setIcon ( getIconForCurrentState , var , var )
var . setBackground ( getDrawableForCurrentState , false , var )	var . setIcon ( getIconForCurrentState , false , var )
TLRPC . PhotoSize var = FileLoader . getClosestPhotoSizeWithSize ( var . thumbs , 90 )	TLRPC . PhotoSize var = FileLoader . getClosestPhotoSizeWithSize ( var . thumbs , 40 )
var . setBackground ( getDrawableForCurrentState , true , var )	var . setIcon ( getIconForCurrentState , true , var )
var . setBackground ( getDrawableForCurrentState , false , var )	var . setIcon ( getIconForCurrentState , false , var )
var = new RadialProgress ( this )	var = new RadialProgress2 ( this )
var . setAlphaForPrevious ( true )	updateButtonState ( true )
var . setDiff ( AndroidUtilities . dp ( 0 ) )	var . setCircleRadius ( AndroidUtilities . dp ( 24 ) )
var . setStrokeWidth ( AndroidUtilities . dp ( 2 ) )	var . setBackgroundStroke ( AndroidUtilities . dp ( 3 ) )
didPressedButton ( false )	didPressedButton ( true )
var = AndroidUtilities . dp ( 7 )	int var = AndroidUtilities . dp ( 44 )
var . setBackground ( getDrawableForCurrentState , false , var )	var . setIcon ( getIconForCurrentState , false , var )
var . setBackground ( getDrawableForCurrentState , true , var )	var . setIcon ( getIconForCurrentState , true , var )
var . setBackground ( getDrawableForCurrentState , false , false )	var . setIcon ( getIconForCurrentState , false , var )
var . setBackground ( getDrawableForCurrentState , false , false )	var . setIcon ( getIconForCurrentState , false , var )
var . setBackground ( getDrawableForCurrentState , true , false )	var . setIcon ( getIconForCurrentState , true , var )
var . setBackground ( getDrawableForCurrentState , false , false )	var . setIcon ( getIconForCurrentState , false , var )
updateButtonState ( false )	updateButtonState ( true )
var = new RadialProgress ( this )	var = new RadialProgress2 ( this )
var . setAlphaForPrevious ( true )	didPressedButton ( true )
var = false	var = 0
return var || checkLayoutForLinks ( var , this , var , var , var ) || checkLayoutForLinks ( var , this , var , var , var + var ) || super . onTouchEvent ( var )	return var || var != 0 || checkLayoutForLinks ( var , this , var , var , var ) || checkLayoutForLinks ( var , this , var , var , var + var ) || super . onTouchEvent ( var )
var . setImage ( ImageLocation . getForPhoto ( var , var ) , var , var , ImageLocation . getForPhoto ( var , var ) , var , "" , var . var , null , currentPage , 1 )	var . setImage ( ImageLocation . getForPhoto ( var , var ) , var , var , ImageLocation . getForPhoto ( var , var ) , var , var , var . var , null , currentPage , 1 )
if ( var >= 0 && var < 6 )	if ( var == 0 == 1 )
var . setBackground ( null , false , false )	var . setIcon ( MediaActionDrawable . ICON_NONE , false , false )
var . setBackground ( getDrawableForCurrentState , false , var )	var . setIcon ( getIconForCurrentState , false , var )
if ( FileLoader . getInstance ( currentAccount ) . isLoadingFile ( var ) )	if ( var || FileLoader . getInstance ( currentAccount ) . isLoadingFile ( var ) = 0 )
var . setBackground ( getDrawableForCurrentState , true , var )	var . setIcon ( getIconForCurrentState , true , var )
String lines = var . split ( "" )	String var = var . split ( "" )
int var = ( var . getWidth ( ) - var ) / 2	int var = ( getWidth - var ) / 2
if ( var == var . type != 13 || var . getInputStickerSet ( ) != null )	if ( var == var var . isAnyKindOfSticker ( ) || var . getInputStickerSet ( ) != null )
if ( var . type != 13 || var . getInputStickerSet ( ) != null )	if ( ! var . isAnyKindOfSticker ( ) || var . getInputStickerSet ( ) != null )
if ( var . type == 13 || var . type == 5 )	if ( var . shouldDrawWithoutBackground ( ) )
var . didPressChannelAvatar ( this , var , 0 , var , var )	var . didPressChannelAvatar ( this , var , var . messageOwner . fwd_from . channel_post , var , var )
if ( var . type == 13 || var . type == 5 )	if ( var . shouldDrawWithoutBackground ( ) )
if ( var . type == 5 )	if ( var . type == MessageObject . TYPE_ROUND_VIDEO )
return var . type == 1 || var . type == 5 || var . type == 3 || var . type == 8 || var . type == 13	return var . type == 1 || var . type == MessageObject . TYPE_ROUND_VIDEO || var . type == 3 || var . type == 8 || var . isAnyKindOfSticker ( )
if ( var != null && var . replyMessageObject . type != 13 = var )	if ( var != null && ! var . replyMessageObject . isAnyKindOfSticker ( ) = var )
var = var . messageOwner . fwd_from != null && var . type != 13	var = var . messageOwner . fwd_from != null && ! var . isAnyKindOfSticker ( )
if ( var . gifState != 2 && ! SharedConfig . autoplayGifs && ( var . type == 8 || var . type == 5 ) )	if ( var . gifState != 2 && ! SharedConfig . autoplayGifs && ( var . type == 8 || var . type == MessageObject . TYPE_ROUND_VIDEO ) )
if ( var . type == 13 )	boolean var = var . type == MessageObject . TYPE_STICKER
boolean var = false	boolean var = var . type == MessageObject . TYPE_STICKER
if ( var instanceof TLRPC . TL_documentAttributeImageSize instanceof TLRPC . TL_documentAttributeAnimated = true )	if ( var instanceof TLRPC . TL_documentAttributeImageSize )
if ( var . type == 5 )	if ( var . type == MessageObject . TYPE_ROUND_VIDEO )
if ( var . type == 5 )	if ( var . type == MessageObject . TYPE_ROUND_VIDEO )
if ( var . type == 5 )	if ( var . type == MessageObject . TYPE_ROUND_VIDEO )
if ( var . type == 5 )	if ( var . type == MessageObject . TYPE_ROUND_VIDEO )
if ( var . photoThumbs != null && var . photoThumbs . size ( ) > 1 || var . type == 3 || var . type == 8 || var . type == 5 )	if ( var . photoThumbs != null && var . photoThumbs . size ( ) > 1 || var . type == 3 || var . type == 8 || var . type == MessageObject . TYPE_ROUND_VIDEO )
if ( var . type == 3 || var . type == 8 || var . type == 5 = true )	if ( var . type == 3 || var . type == 8 || var . type == MessageObject . TYPE_ROUND_VIDEO = true )
if ( var . type == 8 || var . type == 5 )	if ( var . type == 8 || var . type == MessageObject . TYPE_ROUND_VIDEO )
if ( MessageObject . isGifDocument ( var . messageOwner . media . document ) || var . type == 5 )	if ( MessageObject . isGifDocument ( var . messageOwner . media . document ) || var . type == MessageObject . TYPE_ROUND_VIDEO )
if ( var == null && var . type != 13 && var == 0 )	if ( var == null && ! var . isAnyKindOfSticker ( ) && var == 0 )
if ( var . type == 13 && var < AndroidUtilities . dp ( 70 ) )	if ( var . isAnyKindOfSticker ( ) && var < AndroidUtilities . dp ( 70 ) )
if ( var . type == 5 && Theme . chat_roundVideoShadow != null )	if ( var . type == MessageObject . TYPE_ROUND_VIDEO && Theme . chat_roundVideoShadow != null )
if ( var && var . type == 5 )	if ( var && var . type == MessageObject . TYPE_ROUND_VIDEO )
if ( var . type == 5 )	if ( var . type == MessageObject . TYPE_ROUND_VIDEO )
if ( var . var instanceof TLRPC . TL_keyboardButtonCallback || var . var instanceof TLRPC . TL_keyboardButtonRequestGeoLocation || var . var instanceof TLRPC . TL_keyboardButtonGame || var . var instanceof TLRPC . TL_keyboardButtonBuy )	if ( var . var instanceof TLRPC . TL_keyboardButtonCallback || var . var instanceof TLRPC . TL_keyboardButtonRequestGeoLocation || var . var instanceof TLRPC . TL_keyboardButtonGame || var . var instanceof TLRPC . TL_keyboardButtonBuy || var . var instanceof TLRPC . TL_keyboardButtonUrlAuth )
boolean var = ( var . var instanceof TLRPC . TL_keyboardButtonCallback || var . var instanceof TLRPC . TL_keyboardButtonGame || var . var instanceof TLRPC . TL_keyboardButtonBuy ) && SendMessagesHelper . getInstance ( var ) . isSendingCallback ( var , var . var ) || var . var instanceof TLRPC . TL_keyboardButtonRequestGeoLocation && SendMessagesHelper . getInstance ( var ) . isSendingCurrentLocation ( var , var . var )	boolean var = ( var . var instanceof TLRPC . TL_keyboardButtonCallback || var . var instanceof TLRPC . TL_keyboardButtonGame || var . var instanceof TLRPC . TL_keyboardButtonBuy || var . var instanceof TLRPC . TL_keyboardButtonUrlAuth ) && SendMessagesHelper . getInstance ( var ) . isSendingCallback ( var , var . var ) || var . var instanceof TLRPC . TL_keyboardButtonRequestGeoLocation && SendMessagesHelper . getInstance ( var ) . isSendingCurrentLocation ( var , var . var )
if ( var == var || var == var || var . type == 5 )	if ( var == var || var == var || var . type == MessageObject . TYPE_ROUND_VIDEO )
if ( var . type == 0 || var . type == 1 || var . type == 8 || var . type == 5 )	if ( var . type == 0 || var . type == 1 || var . type == 8 || var . type == MessageObject . TYPE_ROUND_VIDEO )
if ( var . type == 5 )	if ( var . type == MessageObject . TYPE_ROUND_VIDEO )
if ( var != null && ! var . isOutOwner ( ) && var . type != 13 && var . type != 5 && var . isChatAdminCell ( var . id ) )	if ( var != null && ! var . isOutOwner ( ) && ! var . isAnyKindOfSticker ( ) && var . type != 5 && var . isChatAdminCell ( var . id ) )
if ( var . type == 13 || var . type == 5 )	if ( var . shouldDrawWithoutBackground ( ) )
SpannableStringBuilder var = new SpannableStringBuilder ( String . format ( "" , var , var ) , var , var )	SpannableStringBuilder var = new SpannableStringBuilder ( String . format ( "" , var , LocaleController . getString ( "" , R . string . ViaBot ) , R . string . ViaBot , var ) , var , LocaleController . getString ( "" , R . string . ViaBot ) , R . string . ViaBot , var )
SpannableStringBuilder var = new SpannableStringBuilder ( String . format ( "" , var ) , var )	SpannableStringBuilder var = new SpannableStringBuilder ( String . format ( "" , LocaleController . getString ( "" , R . string . ViaBot ) , R . string . ViaBot , var ) , LocaleController . getString ( "" , R . string . ViaBot ) , R . string . ViaBot , var )
if ( var . type != 13 )	if ( ! var . isAnyKindOfSticker ( ) )
var = new SpannableStringBuilder ( String . format ( "" , var , var ) , var , var )	var = new SpannableStringBuilder ( String . format ( "" , var , LocaleController . getString ( "" , R . string . ViaBot ) , R . string . ViaBot , var ) , var , LocaleController . getString ( "" , R . string . ViaBot ) , R . string . ViaBot , var )
if ( var . type != 13 && var . type != 5 )	if ( ! var . isAnyKindOfSticker ( ) && var . type != 5 )
if ( var . type == 5 )	if ( var . type == MessageObject . TYPE_ROUND_VIDEO )
if ( var == null || var . replyMessageObject . type == 13 || var . type == 13 && ! AndroidUtilities . isTablet ( ) || var . replyMessageObject . isSecretMedia ( ) )	if ( var == null || var . replyMessageObject . isAnyKindOfSticker ( ) || var . isAnyKindOfSticker ( ) && ! AndroidUtilities . isTablet ( ) || var . replyMessageObject . isSecretMedia ( ) )
if ( var . type == 5 )	if ( var . type == MessageObject . TYPE_ROUND_VIDEO )
if ( var . type == 13 || var . type == 5 )	if ( var . shouldDrawWithoutBackground ( ) )
if ( var . type == 13 || var . type == 5 )	if ( var . shouldDrawWithoutBackground ( ) )
if ( var . type == 5 )	if ( var . type == MessageObject . TYPE_ROUND_VIDEO )
if ( var . type == 13 || var . type == 5 )	if ( var . shouldDrawWithoutBackground ( ) )
if ( var . type == 5 )	if ( var . type == MessageObject . TYPE_ROUND_VIDEO )
if ( var . type == 13 || var . type == 5 )	if ( var . shouldDrawWithoutBackground ( ) )
if ( var . type == 5 )	if ( var . type == MessageObject . TYPE_ROUND_VIDEO )
if ( var . type == 13 || var . type == 5 )	if ( var . shouldDrawWithoutBackground ( ) )
if ( var . type == 13 || var . type == 5 )	if ( var . shouldDrawWithoutBackground ( ) )
if ( var . type == 13 || var . type == 5 )	if ( var . shouldDrawWithoutBackground ( ) )
if ( var . type == 13 || var . type == 5 )	if ( var . shouldDrawWithoutBackground ( ) )
if ( var . type == 13 || var . type == 5 )	if ( var . shouldDrawWithoutBackground ( ) )
if ( var . type == 13 || var . type == 5 )	if ( var . shouldDrawWithoutBackground ( ) )
public DialogCell ( Context var , boolean var )	public DialogCell ( Context var , boolean var , boolean var )
TLRPC . EncryptedChat var = MessagesController . getInstance ( var ) . getEncryptedChat ( ( int ) var . id )	TLRPC . EncryptedChat var = MessagesController . getInstance ( var ) . getEncryptedChat ( int ( var . id >> 32 ) . id >> 32 )
if ( SharedConfig . useThreeLinesLayout )	if ( var || SharedConfig . useThreeLinesLayout )
if ( ! SharedConfig . useThreeLinesLayout || var != 0 )	if ( ! var && ! SharedConfig . useThreeLinesLayout || var != 0 )
if ( ! SharedConfig . useThreeLinesLayout || var != 0 )	if ( ! var && ! SharedConfig . useThreeLinesLayout || var != 0 )
if ( SharedConfig . useThreeLinesLayout )	if ( var || SharedConfig . useThreeLinesLayout )
if ( SharedConfig . useThreeLinesLayout )	if ( var || SharedConfig . useThreeLinesLayout )
if ( SharedConfig . useThreeLinesLayout )	if ( var || SharedConfig . useThreeLinesLayout )
if ( SharedConfig . useThreeLinesLayout )	if ( var || SharedConfig . useThreeLinesLayout )
if ( SharedConfig . useThreeLinesLayout )	if ( var || SharedConfig . useThreeLinesLayout )
if ( SharedConfig . useThreeLinesLayout )	if ( var || SharedConfig . useThreeLinesLayout )
if ( SharedConfig . useThreeLinesLayout )	if ( var || SharedConfig . useThreeLinesLayout )
if ( SharedConfig . useThreeLinesLayout )	if ( var || SharedConfig . useThreeLinesLayout )
if ( SharedConfig . useThreeLinesLayout = "" )	if ( var || SharedConfig . useThreeLinesLayout = "" )
if ( SharedConfig . useThreeLinesLayout )	if ( var || SharedConfig . useThreeLinesLayout )
if ( ! SharedConfig . useThreeLinesLayout && var != 0 )	if ( ! var && ! SharedConfig . useThreeLinesLayout && var != 0 )
if ( SharedConfig . useThreeLinesLayout )	if ( var || SharedConfig . useThreeLinesLayout )
if ( ! SharedConfig . useThreeLinesLayout || var != 0 && var . length ( ) > 0 )	if ( ! var && ! SharedConfig . useThreeLinesLayout || var != 0 && var . length ( ) > 0 )
if ( var == 0 && MessagesController . getInstance ( var ) . isProxyDialog ( var ) )	if ( var == 0 && MessagesController . getInstance ( var ) . isProxyDialog ( var , true ) )
if ( SharedConfig . useThreeLinesLayout )	if ( var || SharedConfig . useThreeLinesLayout )
if ( ! SharedConfig . useThreeLinesLayout || var != null )	if ( ! var && ! SharedConfig . useThreeLinesLayout || var != null )
if ( SharedConfig . useThreeLinesLayout && var != null && ( var == 0 || var == 1 ) )	if ( ( var || SharedConfig . useThreeLinesLayout ) && var != null && ( var == 0 || var == 1 ) )
if ( SharedConfig . useThreeLinesLayout )	if ( var || SharedConfig . useThreeLinesLayout )
if ( ! SharedConfig . useThreeLinesLayout || var != null )	if ( ! var && ! SharedConfig . useThreeLinesLayout || var != null )
if ( SharedConfig . useThreeLinesLayout )	if ( var || SharedConfig . useThreeLinesLayout )
if ( var != null )	if ( var != null || var != null && var . type == 2 )
if ( var != null )	if ( var != null && var == 0 )
var . setVisibility ( INVISIBLE )	var . setVisibility ( var )
var = new GroupCreateCheckBox ( var )	var = new CheckBox2 ( var )
var . setVisibility ( VISIBLE )	var . setColor ( null , Theme . key_windowBackgroundWhite , Theme . key_checkboxCheck )
if ( var != null && var == null || var == null && var != null && var != null && var != null && ( var . volume_id != var . volume_id || var . local_id != var . local_id ) = true )	if ( var != null && var == null || var == null && var != null || var != null && var != null && ( var . volume_id != var . volume_id || var . local_id != var . local_id ) = true )
if ( var != null )	if ( var == null )
var = new GroupCreateCheckBox ( var )	var = new CheckBox2 ( var )
var . setVisibility ( VISIBLE )	var . setColor ( null , Theme . key_windowBackgroundWhite , Theme . key_checkboxCheck )
public LoadingCell ( Context var )	public LoadingCell ( Context var , int var , int var )
super . onMeasure ( MeasureSpec . makeMeasureSpec ( MeasureSpec . getSize ( var ) , MeasureSpec . EXACTLY ) . getSize ( var ) , MeasureSpec . EXACTLY , MeasureSpec . makeMeasureSpec ( AndroidUtilities . dp ( 54 ) , MeasureSpec . EXACTLY ) . dp ( 54 ) , MeasureSpec . EXACTLY )	super . onMeasure ( MeasureSpec . makeMeasureSpec ( MeasureSpec . getSize ( var ) , MeasureSpec . EXACTLY ) . getSize ( var ) , MeasureSpec . EXACTLY , MeasureSpec . makeMeasureSpec ( var , MeasureSpec . EXACTLY ) , MeasureSpec . EXACTLY )
var . setPadding ( 0 , AndroidUtilities . dp ( 7 ) , 0 , 0 )	var . setPadding ( 0 , AndroidUtilities . dp ( 5 ) , 0 , 0 )
if ( var != null && var == null || var == null && var != null && var != null && var != null && ( var . volume_id != var . volume_id || var . local_id != var . local_id ) = true )	if ( var != null && var == null || var == null && var != null || var != null && var != null && ( var . volume_id != var . volume_id || var . local_id != var . local_id ) = true )
public NotificationsCheckCell ( Context var , int var )	public NotificationsCheckCell ( Context var , int var , int var )
super . onMeasure ( MeasureSpec . makeMeasureSpec ( MeasureSpec . getSize ( var ) , MeasureSpec . EXACTLY ) . getSize ( var ) , MeasureSpec . EXACTLY , MeasureSpec . makeMeasureSpec ( AndroidUtilities . dp ( 70 ) , MeasureSpec . EXACTLY ) . dp ( 70 ) , MeasureSpec . EXACTLY )	super . onMeasure ( MeasureSpec . makeMeasureSpec ( MeasureSpec . getSize ( var ) , MeasureSpec . EXACTLY ) . getSize ( var ) , MeasureSpec . EXACTLY , MeasureSpec . makeMeasureSpec ( AndroidUtilities . dp ( var ) , MeasureSpec . EXACTLY ) . dp ( var ) , MeasureSpec . EXACTLY )
var . setRoundRadius ( AndroidUtilities . dp ( 26 ) )	var . setRoundRadius ( AndroidUtilities . dp ( 23 ) )
var = AndroidUtilities . dp ( 16.5f )	var = AndroidUtilities . dp ( 24 )
var = AndroidUtilities . dp ( 28.5f )	var = AndroidUtilities . dp ( 20.5f )
var = AndroidUtilities . dp ( 28.5f )	var = AndroidUtilities . dp ( 22.5f )
var = AndroidUtilities . dp ( 30 )	var = AndroidUtilities . dp ( 22.5f )
if ( var . bot && ! MessagesController . isSupportUser ( var ) )	if ( SharedConfig . drawDialogIcons && var . bot && ! MessagesController . isSupportUser ( var ) )
var = AndroidUtilities . dp ( 16.5f )	var = AndroidUtilities . dp ( 21 )
var = AndroidUtilities . dp ( 17 )	var = AndroidUtilities . dp ( 20.5f )
var = Theme . dialogs_nameEncryptedPaint	var = Theme . dialogs_searchNameEncryptedPaint
var = Theme . dialogs_namePaint	var = Theme . dialogs_searchNamePaint
var = AndroidUtilities . dp ( 25 )	var . setImageCoords ( var , AndroidUtilities . dp ( 7 ) , AndroidUtilities . dp ( 46 ) , AndroidUtilities . dp ( 46 ) )
var = AndroidUtilities . dp ( 13 )	var . setImageCoords ( var , AndroidUtilities . dp ( 7 ) , AndroidUtilities . dp ( 46 ) , AndroidUtilities . dp ( 46 ) )
var -= AndroidUtilities . dp ( 12 )	CharSequence var = TextUtils . ellipsize ( var , var , var - AndroidUtilities . dp ( 12 ) , TextUtils . TruncateAt . END )
var = var . getLineLeft ( 0 )	var = Math . ceil ( var . getLineWidth ( 0 ) )
var = Math . ceil ( var . getLineWidth ( 0 ) )	var = var . getLineRight ( 0 )
var = var . getLineRight ( 0 )	var = Math . ceil ( var . getLineWidth ( 0 ) )
var = Math . ceil ( var . getLineWidth ( 0 ) )	var = var . getLineLeft ( 0 )
setDrawableBounds ( Theme . dialogs_verifiedDrawable , var , var )	setDrawableBounds ( Theme . dialogs_verifiedDrawable , var , var + AndroidUtilities . dp ( 3 ) )
setDrawableBounds ( Theme . dialogs_verifiedCheckDrawable , var , var )	setDrawableBounds ( Theme . dialogs_verifiedCheckDrawable , var , var + AndroidUtilities . dp ( 3 ) )
var . setText ( var . getText ( ) + "" + var )	var . append ( var . getText ( ) )
var . setTitle ( LocaleController . getString ( "" , R . string . AppName ) , R . string . AppName )	var . setTitle ( LocaleController . getString ( "" , R . string . OpenUrlTitle ) , R . string . OpenUrlTitle )
var . setMessage ( LocaleController . formatString ( "" , R . string . OpenUrlAlert , var ) , R . string . OpenUrlAlert , var )	var . setMessage ( LocaleController . formatString ( "" , R . string . OpenUrlAlert2 , var ) , R . string . OpenUrlAlert2 , var )
