for ( int var = 1 ; var < var . length ; var ++ )	for ( int var = 0 ; var < var . length ; var ++ )
var = var . renameTo ( var )	boolean var = var . renameTo ( var )
if ( var . isDirectory ( ) )	if ( var . isDirectory ( ) && canMoveFiles ( var , var ) )
if ( var . isDirectory ( ) )	if ( var . isDirectory ( ) && canMoveFiles ( var , var ) )
if ( var . isDirectory ( ) )	if ( var . isDirectory ( ) && canMoveFiles ( var , var ) )
if ( var . isDirectory ( ) )	if ( var . isDirectory ( ) && canMoveFiles ( var , var ) )
if ( var < 20 )	if ( var < 21 )
return SharedMediaQuery . var	if ( var . media instanceof TLRPC . TL_messageMediaWebPage )
return SharedMediaQuery . var	return var
return SharedMediaQuery . var	return var
if ( var == 0 )	if ( MarkerLog . ENABLED )
var = SystemClock . elapsedRealtime ( )	var . add ( var , Thread . currentThread ( ) . getId )
long var = SystemClock . elapsedRealtime ( ) - var	final long var = Thread . currentThread ( ) . getId
VolleyLog . d ( "" , var , this . toString ( ) )	var . finish ( this . toString ( ) )
if ( var != null )	if ( var [ var ] != null )
var . quit ( )	var [ var ] . quit
void finish ( Request < ? > var )	T finish ( Request < T > var )
AccountManager . get ( var ) . invalidateAuthToken ( var . type , var )	var . invalidateAuthToken ( var . type , var )
Cache . Entry var = var . getCacheEntry ( )	Entry var = var . getCacheEntry ( )
if ( var . serverDate > 0 )	if ( var . lastModified > 0 )
Date var = new Date ( var . serverDate )	Date var = new Date ( var . lastModified )
var = new CountingInputStream ( new FileInputStream ( var ) )	var = new CountingInputStream ( new BufferedInputStream ( new FileInputStream ( var ) ) FileInputStream ( var ) )
FileOutputStream var = new FileOutputStream ( var )	BufferedOutputStream var = new BufferedOutputStream ( new FileOutputStream ( var ) )
String var = var . trim ( )	String var = var [ var ] . trim
if ( var . equals ( "" ) || var . equals ( "" ) = 0 )	if ( var . equals ( "" ) || var . equals ( "" ) = true )
var = 0	var = true
var . ttl = var . softTtl	var . ttl = var
return HTTP . DEFAULT_CONTENT_CHARSET	return parseCharset ( var , HTTP . DEFAULT_CONTENT_CHARSET )
final String var = getCacheKey ( var , var , var )	String var = getCacheKey ( var , var , var , var )
Request < Bitmap > var = makeImageRequest ( var , var , var , var )	Request < Bitmap > var = makeImageRequest ( var , var , var , var , var )
public ImageRequest ( String var , Response . Listener < Bitmap > var , int var , int var , Config var , Response . ErrorListener var )	public ImageRequest ( String var , Response . Listener < Bitmap > var , int var , int var , ScaleType var , Config var , Response . ErrorListener var )
if ( var == 0 && var == 0 )	if ( ( var == 0 ) && ( var == 0 ) )
if ( var * var > var )	if ( ( var * var ) < var )
int var = getResizedDimension ( var , var , var , var )	int var = getResizedDimension ( var , var , var , var , var )
int var = getResizedDimension ( var , var , var , var )	int var = getResizedDimension ( var , var , var , var , var )
public JsonArrayRequest ( String var , Response . Listener < JSONArray > var , Response . ErrorListener var )	public JsonArrayRequest ( String var , Listener < JSONArray > var , ErrorListener var )
String var = new String ( var . data , HttpHeaderParser . parseCharset ( var . headers ) . headers )	String var = new String ( var . data , HttpHeaderParser . parseCharset ( var . headers , PROTOCOL_CHARSET ) . headers , PROTOCOL_CHARSET )
public JsonObjectRequest ( int var , String var , JSONObject var , Response . Listener < JSONObject > var , Response . ErrorListener var )	public JsonObjectRequest ( int var , String var , JSONObject var , Listener < JSONObject > var , ErrorListener var )
public JsonObjectRequest ( String var , JSONObject var , Response . Listener < JSONObject > var , Response . ErrorListener var )	public JsonObjectRequest ( String var , JSONObject var , Listener < JSONObject > var , ErrorListener var )
String var = new String ( var . data , HttpHeaderParser . parseCharset ( var . headers ) . headers )	String var = new String ( var . data , HttpHeaderParser . parseCharset ( var . headers , PROTOCOL_CHARSET ) . headers , PROTOCOL_CHARSET )
public JsonRequest ( String var , String var , Response . Listener < T > var , Response . ErrorListener var )	public JsonRequest ( String var , String var , Listener < T > var , ErrorListener var )
public JsonRequest ( int var , String var , String var , Response . Listener < T > var , Response . ErrorListener var )	public JsonRequest ( int var , String var , String var , Listener < T > var , ErrorListener var )
return var != null && var . isCanceled ( )	return var . isCanceled ( )
public StringRequest ( int var , String var , Response . Listener < String > var , Response . ErrorListener var )	public StringRequest ( int var , String var , Listener < String > var , ErrorListener var )
public StringRequest ( String var , Response . Listener < String > var , Response . ErrorListener var )	public StringRequest ( String var , Listener < String > var , ErrorListener var )
if ( var . var . capacity ( ) == 128 = var . var . capacity ( ) == 1024 + 200 = var )	if ( var . var . capacity ( ) == 128 = var . var . capacity ( ) == 1024 + 200 = var . var . capacity ( ) == 4096 + 200 = var . var . capacity ( ) == 16384 + 200 = var . var . capacity ( ) == 40000 = var . var . capacity ( ) == 280000 )
if ( var . var . capacity ( ) == 4096 + 200 = var . var . capacity ( ) == 16384 + 200 = var . var . capacity ( ) == 40000 = var . var . capacity ( ) == 280000 )	if ( var . var . capacity ( ) == 128 = var . var . capacity ( ) == 1024 + 200 = var . var . capacity ( ) == 4096 + 200 = var . var . capacity ( ) == 16384 + 200 = var . var . capacity ( ) == 40000 = var . var . capacity ( ) == 280000 )
if ( ! var . renameTo ( var ) = var )	if ( ! var . renameTo ( var ) )
if ( var . var == null || var . var . var != null || var . var . volume_id == Integer . MIN_VALUE && var . var . local_id < 0 )	if ( var . var == null || var . var . var != null || var . var . volume_id == Integer . MIN_VALUE && var . var . local_id < 0 || var . size < 0 )
int var = var . get ( var )	Integer var = var . get ( var )
if ( var - ( var * AndroidUtilities . dp ( 48 ) + AndroidUtilities . dp ( 32 ) ) > var * var )	if ( var != null && var - ( var * AndroidUtilities . dp ( 48 ) + AndroidUtilities . dp ( 32 ) ) > var * var )
int var = var . get ( var )	Integer var = var . get ( var )
if ( ( var + 1 ) * AndroidUtilities . dp ( 48 ) - AndroidUtilities . dp ( 24 ) > var * var )	if ( var != null && ( var + 1 ) * AndroidUtilities . dp ( 48 ) - AndroidUtilities . dp ( 24 ) > var * var )
public DialogsSearchAdapter ( Context var , int var )	public DialogsSearchAdapter ( Context var , int var , int var )
searchDialogsInternal ( var , var , var )	searchDialogsInternal ( var , var )
var . setData ( var , var , var , var , var )	var . setData ( var , var , var , var , var , var )
( ( ProfileSearchCell ) var ) . setData ( var , null , null , var , var )	( ( ProfileSearchCell ) var ) . setData ( var , null , null , var , var , false )
var = ( int ) Math . ceil ( Math . max ( var , var . getLineWidth ( var ) - var . getLineLeft ( var ) ) , var . getLineWidth ( var ) - var . getLineLeft ( var ) )	var = ( int ) Math . ceil ( Math . max ( var , var . getLineWidth ( var ) + var . getLineLeft ( var ) ) , var . getLineWidth ( var ) + var . getLineLeft ( var ) )
var . translate ( var = AndroidUtilities . dp ( 2 + 9 ) + 9 + var - var , var = AndroidUtilities . dp ( 2 + 9 ) + 9 + var )	var . translate ( var = AndroidUtilities . dp ( 2 + 9 ) + 9 + var , var = AndroidUtilities . dp ( 2 + 9 ) + 9 + var )
var . onDraw ( var )	var . draw ( var )
if ( var != null )	if ( delegate != null )
var . didClickedImage ( this )	delegate . didClickedImage ( this )
if ( var != null )	if ( delegate != null )
var . didClickedImage ( this )	delegate . didClickedImage ( this )
if ( var != null )	if ( delegate != null )
var . didClickedImage ( this )	delegate . didClickedImage ( this )
if ( var != null )	if ( delegate != null )
var . didClickedImage ( this )	delegate . didClickedImage ( this )
var . onDraw ( var )	var . draw ( var )
if ( var . getAction ( ) == MotionEvent . ACTION_DOWN || ( linkPreviewPressed || pressedLink != null ) && var . getAction ( ) == MotionEvent . ACTION_UP . getAction ( ) == MotionEvent . ACTION_CANCEL )	if ( var . getAction ( ) == MotionEvent . ACTION_DOWN || ( linkPreviewPressed || pressedLink != null || var ) && var . getAction ( ) == MotionEvent . ACTION_UP . getAction ( ) == MotionEvent . ACTION_CANCEL )
if ( Build . VERSION . SDK_INT >= 19 && var . embed_url != null && var . embed_url . length ( ) != 0 )	if ( Build . VERSION . SDK_INT >= 16 && var . embed_url != null && var . embed_url . length ( ) != 0 )
var . onAttachedToWindow ( )	if ( var . onAttachedToWindow ( ) )
if ( currentMessageObject != var || isUserDataChanged )	if ( currentMessageObject != var || var )
var . onDraw ( var )	var . draw ( var )
CharSequence var	CharSequence var = ""
if ( var != null = var )	if ( var != null = var != null )
if ( var . getImageReceiver ( ) . getPressed != var )	return var . getImageReceiver ( ) . getBitmap != null
var . getImageReceiver ( ) . setPressed ( var )	var . getImageReceiver ( ) . setAlpha ( var )
super . setPressed ( var )	var . setScaleX ( var )
if ( var != null )	if ( var != null . getInstance ( ) . isVisible )
if ( var . contains ( "" ) )	if ( var != - 1 )
var = var . replace ( "" , "" )	var = var . substring ( 0 , var )
if ( var instanceof ChatMediaCell instanceof ChatActionCell )	if ( var instanceof ChatBaseCell instanceof ChatActionCell )
ChatMediaCell var = ( ChatMediaCell ) var	ChatBaseCell var = ( ChatBaseCell ) var
for ( int var = 0 ; var < Emoji . data . length ; var ++ )	for ( int var = 0 ; var < Emoji . data . length + 1 ; var ++ )
if ( var . getCurrentItem ( ) == 0 )	if ( var . getCurrentItem ( ) != 0 )
var . add ( var )	var . append ( var . getValue ( ) )
Emoji . data [ 0 ] = new long [ Math ] . min ( var . size ( ) , 50 )	var . add ( var . getKey ( ) )
for ( int var = 0 ; var < Emoji . data [ 0 ] . length ; var ++ )	for ( int var = 0 ; var < var . size ( ) ; var ++ )
var . get ( 0 ) . data = Emoji . data [ 0 ]	var . append ( "" )
var . edit ( ) . putString ( "" , var . toString ( ) ) . commit	var . putString ( "" , var . toString ( ) )
var . addStickerTab ( var . documents . get ( 0 ) )	var . addStickerTab ( var . get ( var ) . documents . get ( 0 ) )
Emoji . data [ 0 ] = new long	long var = new long
var . get ( 0 ) . data = Emoji . data [ 0 ]	var . setLength ( 0 )
if ( var != GONE && var != null )	if ( var != null )
var . notifyDataSetChanged ( )	reloadStickersAdapter
var . notifyDataSetChanged ( )	reloadStickersAdapter
TLRPC . Document var = ( ( StickerEmojiCell ) var ) . getSticker	TLRPC . Document var = var . getSticker ( )
public EmojiGridAdapter ( long var )	public EmojiGridAdapter ( int var ) = var
this . var = var	var = var
return var . length	return Emoji . data [ var ] . length
EmojiView . this . addToRecent ( ( Long ) var . getTag ( ) )	var . onEmojiSelected ( convert ( ( Long ) var . getTag ( ) ) Long ) var . getTag ( ) )
var . searchDialogs ( null , var )	var . searchDialogs ( null )
if ( var . length ( ) != 0 )	if ( var . length ( ) != 0 || var != null && var . hasRecentRearch ( ) )
if ( var && var )	if ( var && var || var . isRecentSearchDisplayed ( ) )
if ( var instanceof String )	if ( var instanceof String || var . isRecentSearchDisplayed ( ) )
getParentActivity . unregisterReceiver ( var )	ApplicationLoader . applicationContext . unregisterReceiver ( var )
getParentActivity . registerReceiver ( var , var )	ApplicationLoader . applicationContext . registerReceiver ( var , var )
String var = Environment . getExternalStorageDirectory ( ) . getAbsolutePath	String var = Environment . getExternalStorageDirectory ( ) . getPath
HashMap < String , ArrayList < String > > var = new HashMap	HashSet < String > var = new HashSet
String var = null	BufferedReader var = null
if ( var [ 1 ] . equals ( var ) )	String var = var . nextToken ( )
var . removeAll ( var . get ( var ) )	if ( ! var . contains ( "" ) && ! var . contains ( "" ) && ! var . contains ( "" ) && ! var . contains ( "" ) && ! var . contains ( "" ) )
if ( var != null && var . length ( ) >= 6 )	if ( var != null )
if ( var != null || var != null || var != null )	if ( var != null || var != null || var != null || var != null )
runLinkRequest ( var , var , var , var , var , 0 )	runLinkRequest ( var , var , var , var , var , var , 0 )
runLinkRequest ( var , var , var , var , var , 1 )	runLinkRequest ( var , var , var , var , var , var , 1 )
var . searchDocuments ( null )	var . search ( null )
var . searchDocuments ( var )	var . search ( var )
var = new DocumentsSearchAdapter ( var )	var = new SharedLinksAdapter ( var )
MessageObject var = var . getDocument ( var )	MessageObject var = var . get ( 0 )
MediaActivity . this . onItemClick ( var , var , var , 0 )	MediaActivity . this . onItemClick ( var , var , ( ( SharedDocumentCell ) var ) . getDocument var , 0 )
if ( var == 1 )	if ( var == 1 || var == 3 )
if ( var == 1 )	if ( var == 1 || var == 3 )
if ( var == 1 )	if ( var == 1 || var == 3 )
if ( ! sharedMediaData [ 1 ] . loading && ! sharedMediaData [ 1 ] . endReached && sharedMediaData [ 1 ] . messages . isEmpty ( var ) )	if ( ! sharedMediaData [ var ] . loading && ! sharedMediaData [ var ] . endReached && sharedMediaData [ var ] . messages . isEmpty ( var ) )
public DocumentsSearchAdapter ( Context var ) = var	public SharedLinksAdapter ( Context var ) = var
if ( ! sharedMediaData [ 1 ] . messages . isEmpty ( var ) )	if ( ! sharedMediaData [ var ] . messages . isEmpty ( var ) )
if ( var . messageOwner . media instanceof TLRPC . TL_messageMediaPhoto )	if ( var . messageOwner . media instanceof TLRPC . TL_messageMediaPhoto || var . messageOwner . media instanceof TLRPC . TL_messageMediaWebPage )
if ( var . messageOwner . media instanceof TLRPC . TL_messageMediaPhoto && var . messageOwner . media . photo != null )	if ( var . messageOwner . media instanceof TLRPC . TL_messageMediaPhoto && var . messageOwner . media . photo != null || var . messageOwner . media instanceof TLRPC . TL_messageMediaWebPage && var . messageOwner . media . webpage != null )
if ( var . messageOwner . media instanceof TLRPC . TL_messageMediaPhoto )	if ( var . messageOwner . media instanceof TLRPC . TL_messageMediaPhoto || var . messageOwner . media instanceof TLRPC . TL_messageMediaWebPage )
if ( var . messageOwner . action == null || var . messageOwner . action instanceof TLRPC . TL_messageActionEmpty var )	if ( ! ( var . messageOwner . media instanceof TLRPC . TL_messageMediaWebPage ) && ( var . messageOwner . action == null || var . messageOwner . action instanceof TLRPC . TL_messageActionEmpty ) var )
var = new FrameLayoutTouchListener ( var )	var = new FrameLayout ( var )
