var = GoogleCloudMessaging . getInstance ( this )	var = GoogleCloudMessaging . getInstance ( ApplicationLoader . this )
MessagesController . getInstance ( ) . markDialogAsRead ( var , var , var , 0 , 0 , true , false )	MessagesController . getInstance ( ) . markDialogAsRead ( var , var , var , 0 , true , false )
MessagesController . getInstance ( ) . markDialogAsRead ( var , var , var , 0 , 0 , true , false )	MessagesController . getInstance ( ) . markDialogAsRead ( var , var , var , 0 , true , false )
return var == null || var instanceof TLRPC . TL_chatForbidden || var instanceof TLRPC . TL_channelForbidden || ( var . flags & TLRPC . CHAT_FLAG_USER_LEFT ) != 0	return var == null || var instanceof TLRPC . TL_chatEmpty || var instanceof TLRPC . TL_chatForbidden || var instanceof TLRPC . TL_channelForbidden || var . left || var . deactivated
return var == null || var instanceof TLRPC . TL_chatForbidden || var instanceof TLRPC . TL_channelForbidden || ( var . flags & TLRPC . CHAT_FLAG_USER_KICKED ) != 0	return var == null || var instanceof TLRPC . TL_chatEmpty || var instanceof TLRPC . TL_chatForbidden || var instanceof TLRPC . TL_channelForbidden || var . kicked || var . deactivated
return var == null || var instanceof TLRPC . TL_chatForbidden || var instanceof TLRPC . TL_channelForbidden || ( var . flags & TLRPC . CHAT_FLAG_USER_LEFT ) != 0 || ( var . flags & TLRPC . CHAT_FLAG_USER_KICKED ) != 0	return var == null || var instanceof TLRPC . TL_chatEmpty || var instanceof TLRPC . TL_chatForbidden || var instanceof TLRPC . TL_channelForbidden || var . left || var . kicked || var . deactivated
return var != null && ( ( var . flags & TLRPC . CHAT_FLAG_ADMIN ) != 0 || ( var . flags & TLRPC . CHAT_FLAG_USER_IS_EDITOR ) != 0 )	return var != null && ( var . creator || var . editor || var . megagroup )
return ! isChannel ( var ) || ( var . flags & TLRPC . CHAT_FLAG_ADMIN ) != 0 || ( var . flags & TLRPC . CHAT_FLAG_USER_IS_EDITOR ) != 0 || ( var . flags & TLRPC . CHAT_FLAG_IS_BROADCAST ) == 0	return ! isChannel ( var ) || var . creator || var . editor || ! var . broadcast
if ( ! var . name . equals ( UserConfig . getCurrentUser ( ) . phone ) = true = var )	if ( ! var . name . equals ( "" + UserConfig . getClientUserId ( ) ) = true = var )
var = new Account ( UserConfig . getCurrentUser ( ) . phone , "" )	var = new Account ( "" + UserConfig . getClientUserId ( ) , "" )
if ( ( var . flags & TLRPC . USER_FLAG_MUTUAL_CONTACT ) != 0 )	if ( var . mutual_contact )
var . printStackTrace ( )	FileLog . var ( "" , var )
var . printStackTrace ( )	FileLog . var ( "" , var )
var . printStackTrace ( )	FileLog . var ( "" , var )
var . notify ( )	var . countDown ( )
FileLog . var ( "" , "" + var + "" + var . id + "" + var . access_hash + "" + var . local_id + "" + var . secret )	FileLog . var ( "" , "" + var + "" + var . id + "" + var . local_id + "" + var . access_hash + "" + var . volume_id + "" + var . secret )
FileLoader . getInstance ( ) . setMediaDirs ( createMediaPaths )	FileLoader . getInstance ( ) . setMediaDirs ( var )
return var . format ( var * 1000 )	return getInstance . var . format ( var * 1000 )
return var . format ( var * 1000 )	return getInstance . var . format ( var * 1000 )
return var . format ( new Date ( var * 1000 ) * 1000 )	return getInstance . var . format ( new Date ( var * 1000 ) * 1000 )
return var . format ( new Date ( var * 1000 ) * 1000 )	return getInstance . var . format ( new Date ( var * 1000 ) * 1000 )
return var . format ( new Date ( var * 1000 ) * 1000 )	return getInstance . var . format ( new Date ( var * 1000 ) * 1000 )
return String . format ( "" , LocaleController . getString ( "" , R . string . LastSeen ) , R . string . LastSeen , LocaleController . getString ( "" , R . string . TodayAt ) , R . string . TodayAt , var . format ( new Date ( var * 1000 ) * 1000 ) Date ( var * 1000 ) * 1000 )	return String . format ( "" , LocaleController . getString ( "" , R . string . LastSeen ) , R . string . LastSeen , LocaleController . getString ( "" , R . string . TodayAt ) , R . string . TodayAt , getInstance . var . format ( new Date ( var * 1000 ) * 1000 ) Date ( var * 1000 ) * 1000 )
return String . format ( "" , LocaleController . getString ( "" , R . string . LastSeen ) , R . string . LastSeen , LocaleController . getString ( "" , R . string . YesterdayAt ) , R . string . YesterdayAt , var . format ( new Date ( var * 1000 ) * 1000 ) Date ( var * 1000 ) * 1000 )	return String . format ( "" , LocaleController . getString ( "" , R . string . LastSeen ) , R . string . LastSeen , LocaleController . getString ( "" , R . string . YesterdayAt ) , R . string . YesterdayAt , getInstance . var . format ( new Date ( var * 1000 ) * 1000 ) Date ( var * 1000 ) * 1000 )
String var = LocaleController . formatString ( "" , R . string . formatDateAtTime , var . var ( new Date ( var * 1000 ) * 1000 ) Date ( var * 1000 ) * 1000 , var . var ( new Date ( var * 1000 ) * 1000 ) Date ( var * 1000 ) * 1000 )	String var = LocaleController . formatString ( "" , R . string . formatDateAtTime , getInstance . var . var ( new Date ( var * 1000 ) * 1000 ) Date ( var * 1000 ) * 1000 , getInstance . var . var ( new Date ( var * 1000 ) * 1000 ) Date ( var * 1000 ) * 1000 )
String var = LocaleController . formatString ( "" , R . string . formatDateAtTime , var . var ( new Date ( var * 1000 ) * 1000 ) Date ( var * 1000 ) * 1000 , var . var ( new Date ( var * 1000 ) * 1000 ) Date ( var * 1000 ) * 1000 )	String var = LocaleController . formatString ( "" , R . string . formatDateAtTime , getInstance . var . var ( new Date ( var * 1000 ) * 1000 ) Date ( var * 1000 ) * 1000 , getInstance . var . var ( new Date ( var * 1000 ) * 1000 ) Date ( var * 1000 ) * 1000 )
return var . format ( new Date ( var * 1000 ) * 1000 )	return getInstance . var . format ( new Date ( var * 1000 ) * 1000 )
return var . format ( new Date ( var * 1000 ) * 1000 )	return getInstance . var . format ( new Date ( var * 1000 ) * 1000 )
return var . format ( new Date ( var * 1000 ) * 1000 )	return getInstance . var . format ( new Date ( var * 1000 ) * 1000 )
return var . format ( new Date ( var * 1000 ) * 1000 )	return getInstance . var . format ( new Date ( var * 1000 ) * 1000 )
NotificationCenter . getInstance ( ) . addObserver ( this , NotificationCenter . FileDidFailedLoad )	NotificationCenter . getInstance ( ) . addObserver ( MediaController . this , NotificationCenter . FileDidFailedLoad )
NotificationCenter . getInstance ( ) . addObserver ( this , NotificationCenter . FileDidLoaded )	NotificationCenter . getInstance ( ) . addObserver ( MediaController . this , NotificationCenter . FileDidLoaded )
NotificationCenter . getInstance ( ) . addObserver ( this , NotificationCenter . FileLoadProgressChanged )	NotificationCenter . getInstance ( ) . addObserver ( MediaController . this , NotificationCenter . FileLoadProgressChanged )
NotificationCenter . getInstance ( ) . addObserver ( this , NotificationCenter . FileUploadProgressChanged )	NotificationCenter . getInstance ( ) . addObserver ( MediaController . this , NotificationCenter . FileUploadProgressChanged )
NotificationCenter . getInstance ( ) . addObserver ( this , NotificationCenter . messagesDeleted )	NotificationCenter . getInstance ( ) . addObserver ( MediaController . this , NotificationCenter . messagesDeleted )
NotificationCenter . getInstance ( ) . addObserver ( this , NotificationCenter . removeAllMessagesFromDialog )	NotificationCenter . getInstance ( ) . addObserver ( MediaController . this , NotificationCenter . removeAllMessagesFromDialog )
NotificationCenter . getInstance ( ) . addObserver ( this , NotificationCenter . musicDidLoaded )	NotificationCenter . getInstance ( ) . addObserver ( MediaController . this , NotificationCenter . musicDidLoaded )
var = MediaStore . Images . Media . query ( ApplicationLoader . applicationContext . getContentResolver ( ) , MediaStore . Images . Media . EXTERNAL_CONTENT_URI , var , "" , null , MediaStore . Images . Media . DATE_TAKEN + "" )	var = MediaStore . Images . Media . query ( ApplicationLoader . applicationContext . getContentResolver ( ) , MediaStore . Images . Media . EXTERNAL_CONTENT_URI , var , null , null , MediaStore . Images . Media . DATE_TAKEN + "" )
var = MediaStore . Images . Media . query ( ApplicationLoader . applicationContext . getContentResolver ( ) , MediaStore . Video . Media . EXTERNAL_CONTENT_URI , var , "" , null , MediaStore . Video . Media . DATE_TAKEN + "" )	var = MediaStore . Images . Media . query ( ApplicationLoader . applicationContext . getContentResolver ( ) , MediaStore . Video . Media . EXTERNAL_CONTENT_URI , var , null , null , MediaStore . Video . Media . DATE_TAKEN + "" )
public MessageObject ( TLRPC . Message var , AbstractMap < Integer , TLRPC . User > , TLRPC . User var , boolean var )	public MessageObject ( TLRPC . Message var , AbstractMap < Integer , TLRPC . User > , TLRPC . User var , AbstractMap < Integer , TLRPC . Chat > , TLRPC . Chat var , boolean var )
var = new MessageObject ( var . replyMessage , var , false )	var = new MessageObject ( var . replyMessage , var , var , false )
var = var . get ( var . action . user_id )	var = var . get ( var )
var = MessagesController . getInstance ( ) . getUser ( var . action . user_id )	var = MessagesController . getInstance ( ) . getUser ( var )
if ( var . to_id . channel_id != 0 )	if ( var . to_id . channel_id != 0 && ! isMegagroup )
if ( var . action . user_id == UserConfig . getClientUserId ( ) )	if ( var == UserConfig . getClientUserId ( ) )
if ( var . to_id . channel_id != 0 )	if ( var . to_id . channel_id != 0 && ! isMegagroup )
if ( var . to_id . channel_id != 0 )	if ( var . to_id . channel_id != 0 && ! isMegagroup )
if ( var . to_id . channel_id != 0 )	if ( var . to_id . channel_id != 0 && ! isMegagroup )
if ( var . length ( ) == 0 = "" )	if ( var == null || var . length ( ) == 0 = "" )
if ( var == 1 || var == 2 || var == 0 || var == 8 )	if ( var == 1 || var == 2 || var == 0 || var == 8 == 9 )
var . setSpan ( var , var , var + var . length ( ) , Spanned . SPAN_EXCLUSIVE_EXCLUSIVE )	var . setSpan ( new URLSpanNoUnderlineBold ( "" + var . id ) + var . id , var , var + var . length ( ) , Spanned . SPAN_EXCLUSIVE_EXCLUSIVE )
addUsernamesAndHashtags ( var )	addUsernamesAndHashtags ( var , true )
URLSpanNoUnderline var	URLSpanNoUnderline var = null
if ( var instanceof TLRPC . TL_messageEntityCode )	if ( var instanceof TLRPC . TL_messageEntityCode || var instanceof TLRPC . TL_messageEntityPre )
var . flags &= ~ TLRPC . MESSAGE_FLAG_UNREAD	var = ( ( TLRPC . Chat ) var ) . title
if ( ( var . var & TLRPC . MESSAGE_FLAG_UNREAD ) == 0 |= 1 )	if ( ! var . unread |= 1 )
if ( ( var . var & TLRPC . MESSAGE_FLAG_CONTENT_UNREAD ) == 0 |= 2 )	if ( ! var . media_unread |= 2 )
var . flags &= ~ TLRPC . MESSAGE_FLAG_CONTENT_UNREAD	var = - ( ( TLRPC . Chat ) var ) . var
return var instanceof TLRPC . TL_message_secret && var . media instanceof TLRPC . TL_messageMediaPhoto && var . ttl != 0 && var . ttl <= 60	return var instanceof TLRPC . TL_message_secret && var . media instanceof TLRPC . TL_messageMediaPhoto && var . ttl > 0 && var . ttl <= 60
return var instanceof TLRPC . TL_message_secret && ( var . media instanceof TLRPC . TL_messageMediaPhoto && var . ttl != 0 && var . ttl <= 60 || var . media instanceof TLRPC . TL_messageMediaAudio || var . media instanceof TLRPC . TL_messageMediaVideo )	return var instanceof TLRPC . TL_message_secret && ( var . media instanceof TLRPC . TL_messageMediaPhoto && var . ttl > 0 && var . ttl <= 60 || var . media instanceof TLRPC . TL_messageMediaAudio || var . media instanceof TLRPC . TL_messageMediaVideo )
var . flags |= TLRPC . MESSAGE_FLAG_UNREAD	var . setSpan ( new URLSpanNoUnderlineBold ( "" + var ) + var , var , var + var . length ( ) , Spanned . SPAN_EXCLUSIVE_EXCLUSIVE )
if ( ( var & 2 ) == 0 )	return var . out && var . from_id > 0
var . flags &= ~ TLRPC . MESSAGE_FLAG_CONTENT_UNREAD	var . unread = false
return var . to_id . channel_id != 0 && ( var . from_id <= 0 || ( var . flags & TLRPC . MESSAGE_FLAG_MENTION ) != 0 || ( var . flags & TLRPC . MESSAGE_FLAG_OUT ) != 0 || ( var . flags & TLRPC . MESSAGE_FLAG_HAS_FROM_ID ) == 0 )	return var . to_id . channel_id != 0 && ( var . from_id <= 0 || var . mentioned || var . out || ( var . flags & TLRPC . MESSAGE_FLAG_HAS_FROM_ID ) == 0 )
return ( var . flags & TLRPC . MESSAGE_FLAG_OUT ) != 0	return ( var . flags & TLRPC . MESSAGE_FLAG_MEGAGROUP ) != 0
if ( var . dialog_id == 0 )	if ( var . dialog_id == 0 && var . to_id != null )
if ( ( var . flags & TLRPC . CHAT_FLAG_USER_IS_EDITOR ) != 0 )	if ( var . editor )
if ( ( var . flags & TLRPC . CHAT_FLAG_USER_IS_MODERATOR ) != 0 )	if ( var . moderator )
var = var . getInt ( "" , 100 )	var = var . getInt ( "" , 1000 )
var = var . broadcast_size_max	var = var . megagroup_size_max
TLRPC . Chat var = getChat ( var )	final TLRPC . Chat var = getChat ( var )
if ( ! var . equals ( var . var . first_name + var . var . last_name + var . var . username ) )	if ( var != null && ! var . equals ( var . var . first_name + var . var . last_name + var . var . username ) )
TLRPC . Chat var = ChatObject . getChatByDialog ( var )	final TLRPC . Chat var = ChatObject . getChatByDialog ( var )
var . add ( new MessageObject ( var , var , true ) , var , true )	var . add ( new MessageObject ( var , var , var , true ) , var , var , true )
if ( var || var == null || var + 1500 > System . currentTimeMillis ( ) )	if ( var || var == null || Math . abs ( System . currentTimeMillis ( ) - var ) <= 1500 )
if ( var != null )	if ( var )
if ( ! var )	if ( var != null )
if ( var instanceof TLRPC . TL_dialog -- instanceof TLRPC . TL_dialogChannel )	if ( var . remove ( var ) )
NotificationsController . getInstance ( ) . processDialogsUpdateRead ( var )	NotificationsController . getInstance ( ) . removeNotificationsForDialog ( var )
if ( var . var > 0 )	if ( var . offset > 0 )
if ( var && var > 0 )	if ( var && var > 0 && ! var )
NotificationCenter . getInstance ( ) . postNotificationName ( NotificationCenter . chatInfoDidLoaded , var )	NotificationCenter . getInstance ( ) . postNotificationName ( NotificationCenter . chatInfoDidLoaded , var , 0 , var )
if ( ConnectionsManager . getInstance ( ) . getPauseTime == 0 && ApplicationLoader . isScreenOn && ! ApplicationLoader . mainInterfacePaused != 2 && ! var && ConnectionsManager . getInstance ( ) . getPauseTime <= System . currentTimeMillis ( ) - 2000 )	if ( ConnectionsManager . getInstance ( ) . getPauseTime == 0 && ApplicationLoader . isScreenOn && ! ApplicationLoader . mainInterfacePaused != 2 && ! var && Math . abs ( System . currentTimeMillis ( ) - ConnectionsManager . getInstance ( ) . getPauseTime ) >= 2000 )
if ( var != 1 && ( var == 0 || var <= System . currentTimeMillis ( ) - 55000 || var ) )	if ( var != 1 && ( var == 0 || Math . abs ( System . currentTimeMillis ( ) - var ) >= 55000 || var ) )
if ( var != 2 && ! var && ConnectionsManager . getInstance ( ) . getPauseTime <= System . currentTimeMillis ( ) - 2000 )	if ( var != 2 && ! var && Math . abs ( System . currentTimeMillis ( ) - ConnectionsManager . getInstance ( ) . getPauseTime ) >= 2000 )
if ( ( var . size ( ) != 0 || var . size ( ) != 0 ) && var <= System . currentTimeMillis ( ) - 5000 )	if ( ( var . size ( ) != 0 || var . size ( ) != 0 ) && Math . abs ( System . currentTimeMillis ( ) - var ) >= 5000 )
if ( var . indexOfKey ( var ) > 0 )	if ( var . indexOfKey ( var ) >= 0 )
MessagesStorage . getInstance ( ) . getMessages ( var , var , var , var , var , var , var )	MessagesStorage . getInstance ( ) . getMessages ( var , var , var , var , var , var , var , var )
processLoadedMessages ( var , var , var , var , false , var , 0 , var , 0 , 0 , var , var , false )	processLoadedMessages ( var , var , var , var , false , var , 0 , var , 0 , 0 , var , var , false , var )
loadMessages ( var , var , var , false , 0 , var , var , var , var )	loadMessages ( var , var , var , false , 0 , var , var , var , var , var )
if ( ! var && var . from_id <= 0 && ( var . flags & TLRPC . MESSAGE_FLAG_OUT ) == 0 )	if ( ! var && var . from_id <= 0 && ! var . out )
var . flags |= TLRPC . MESSAGE_FLAG_CONTENT_UNREAD	var . flags |= TLRPC . MESSAGE_FLAG_MEGAGROUP
if ( var . action instanceof TLRPC . TL_messageActionChatDeleteUser )	if ( var . action instanceof TLRPC . TL_messageActionChatDeleteUser . action instanceof TLRPC . TL_messageActionChatMigrateTo || var . action instanceof TLRPC . TL_messageActionChannelCreate )
if ( var != null && ( var . flags & TLRPC . USER_FLAG_BOT ) != 0 )	if ( var != null && var . bot )
NotificationCenter . getInstance ( ) . postNotificationName ( NotificationCenter . messagesDidLoaded , var , var , var , var , var , var , var , var , var , var . collapsed , var )	NotificationCenter . getInstance ( ) . postNotificationName ( NotificationCenter . messagesDidLoaded , var , var , var , var , var , var , var , var , var , var . collapsed , var , var , var )
FileLog . e ( "" , "" + var + "" + var + "" + var + "" + var )	FileLog . e ( "" , "" + var + "" + var + "" + var )
var . var = var	var . offset_id = var
if ( ! UserConfig . channelsLoaded && ! var )	if ( var . to_id . channel_id != 0 . to_id . chat_id != 0 )
TLRPC . TL_channels_getDialogs var = new TLRPC . TL_channels_getDialogs ( )	TLRPC . Chat var = var . get ( var . to_id . channel_id )
UserConfig . channelsLoaded = true	var . flags |= TLRPC . MESSAGE_FLAG_MEGAGROUP
processLoadedDialogs ( var , null , 0 , 0 , 0 , 100 , false , false , true )	processLoadedDialogs ( var , null , 0 , var , false , false , false )
if ( var . to_id . channel_id != 0 )	if ( var . to_id . channel_id != 0 . to_id . chat_id != 0 )
if ( var != null && ( var . flags & TLRPC . CHAT_FLAG_USER_LEFT ) != 0 )	if ( var != null && var . left && ! var . megagroup )
if ( ! var && var . from_id <= 0 && ( var . flags & TLRPC . MESSAGE_FLAG_OUT ) == 0 )	if ( ! var && var . from_id <= 0 && ! var . out )
var . flags |= TLRPC . MESSAGE_FLAG_CONTENT_UNREAD	var . media_unread = true
if ( var == null || var . isImportant ( ) )	if ( var == null || var . isMegagroup ( ) || var . isImportant ( ) )
if ( var instanceof TLRPC . TL_dialogChannel )	if ( var instanceof TLRPC . TL_dialogChannel int ) var . id < 0 )
if ( var . action instanceof TLRPC . TL_messageActionChatDeleteUser )	if ( var . action instanceof TLRPC . TL_messageActionChatDeleteUser . action instanceof TLRPC . TL_messageActionChatMigrateTo || var . action instanceof TLRPC . TL_messageActionChannelCreate )
if ( var != null && ( var . flags & TLRPC . USER_FLAG_BOT ) != 0 )	if ( var != null && var . bot )
if ( var . id < 0 )	if ( var != null && var . migrated_to != null )
var . add ( var )	var . remove ( var )
if ( var . to_id . channel_id != 0 )	if ( var . to_id . channel_id != 0 . to_id . chat_id != 0 )
MessageObject var = new MessageObject ( var , var , false )	MessageObject var = new MessageObject ( var , var , var , false )
if ( var instanceof TLRPC . TL_dialogChannel )	if ( ( int ) var . id < 0 )
if ( var != null && ( var . flags & TLRPC . CHAT_FLAG_USER_LEFT ) != 0 )	if ( var != null && var . migrated_to != null )
if ( var instanceof TLRPC . TL_messages_affectedHistory )	if ( var instanceof TLRPC . TL_messages_affectedMessages )
TLRPC . TL_messages_affectedHistory var = ( TLRPC . TL_messages_affectedHistory ) var	TLRPC . TL_messages_affectedMessages var = ( TLRPC . TL_messages_affectedMessages ) var
if ( var == ChatObject . CHAT_TYPE_CHANNEL )	if ( var == ChatObject . CHAT_TYPE_CHANNEL || var == ChatObject . CHAT_TYPE_MEGAGROUP )
TLRPC . User var = getUser ( var )	TLRPC . User var = var . var . get ( var )
var . flags = 1	var . broadcast = true
NotificationCenter . getInstance ( ) . postNotificationName ( NotificationCenter . chatInfoDidLoaded , var )	NotificationCenter . getInstance ( ) . postNotificationName ( NotificationCenter . chatInfoDidLoaded , var , 0 , false )
var . chat_id = 0	var . peer = getInputPeer ( var . id )
if ( var == null )	if ( var == null || var && ! var )
NotificationCenter . getInstance ( ) . postNotificationName ( NotificationCenter . chatInfoDidLoaded , var )	NotificationCenter . getInstance ( ) . postNotificationName ( NotificationCenter . chatInfoDidLoaded , var , 0 , false )
if ( ( var . flags & TLRPC . CHAT_FLAG_ADMIN ) != 0 )	if ( var . creator )
TLRPC . TL_chatParticipant var = var . participants . participants . get ( var )	TLRPC . ChatParticipant var = var . participants . participants . get ( var )
NotificationCenter . getInstance ( ) . postNotificationName ( NotificationCenter . chatInfoDidLoaded , var )	NotificationCenter . getInstance ( ) . postNotificationName ( NotificationCenter . chatInfoDidLoaded , var , 0 , false )
if ( var != null && ( var || var + 1500 > System . currentTimeMillis ( ) ) )	if ( var != null && ( var || Math . abs ( System . currentTimeMillis ( ) - var ) <= 1500 ) )
if ( getUpdatesStartTime ( var ) != 0 && ( var || getUpdatesStartTime ( var ) + 1500 > System . currentTimeMillis ( ) ) )	if ( getUpdatesStartTime ( var ) != 0 && ( var || Math . abs ( System . currentTimeMillis ( ) - getUpdatesStartTime ( var ) ) <= 1500 ) )
var . put ( var . id , var )	var . peer = getInputPeer ( var . id )
var . flags |= TLRPC . MESSAGE_FLAG_UNREAD	var . media_unread = true
if ( var . action instanceof TLRPC . TL_messageActionChatDeleteUser )	var . flags |= TLRPC . MESSAGE_FLAG_MEGAGROUP
TLRPC . User var = var . get ( var . action . user_id )	Integer var = var . get ( var )
if ( var != null && ( var . flags & TLRPC . USER_FLAG_BOT ) != 0 )	if ( var == null )
var . reply_markup = new TLRPC . TL_replyKeyboardHide ( )	var = MessagesStorage . getInstance ( ) . getChannelReadInboxMax ( var )
TLRPC . Dialog var = var . get ( ( long ) - var )	var = MessagesStorage . getInstance ( ) . getChannelReadInboxMax ( var )
if ( var != null && ( var . flags & TLRPC . CHAT_FLAG_USER_LEFT ) != 0 || var != null && var . read_inbox_max_id >= var . getId ( ) )	if ( var != null && var . left || var >= var . getId ( ) )
var . messages . get ( var ) . dialog_id = - var	TLRPC . Message var = var . messages . get ( var )
MessagesStorage . getInstance ( ) . overwriteChannel ( var , ( TLRPC . TL_updates_channelDifferenceTooLong ) var )	MessagesStorage . getInstance ( ) . overwriteChannel ( var , ( TLRPC . TL_updates_channelDifferenceTooLong ) var , var )
if ( ( var . flags & 1 ) == 0 )	if ( ! var . isFinal )
var . put ( var . id , var )	applyDialogNotificationsSettings ( var . id , var . notify_settings )
if ( var . action instanceof TLRPC . TL_messageActionChatDeleteUser )	if ( var . action instanceof TLRPC . TL_messageActionChatDeleteUser . action instanceof TLRPC . TL_messageActionChatMigrateTo || var . action instanceof TLRPC . TL_messageActionChannelCreate )
if ( var != null && ( var . flags & TLRPC . USER_FLAG_BOT ) != 0 )	if ( var != null && var . bot )
MessageObject var = new MessageObject ( var , var , true )	MessageObject var = new MessageObject ( var , var , var , true )
if ( var == null || ! ChatObject . isChannel ( var ) )	if ( var == null || ! ChatObject . isChannel ( var ) || var . creator )
TLRPC . Chat var = getChat ( var )	final TLRPC . Chat var = getChat ( var )
if ( var == null || ! ChatObject . isChannel ( var ) || ( var . flags & TLRPC . CHAT_FLAG_ADMIN ) != 0 )	if ( var == null || ! ChatObject . isChannel ( var ) || var . megagroup )
var . flags = TLRPC . MESSAGE_FLAG_UNREAD | TLRPC . MESSAGE_FLAG_HAS_FROM_ID | TLRPC . MESSAGE_FLAG_CONTENT_UNREAD	var . flags = TLRPC . MESSAGE_FLAG_HAS_FROM_ID
if ( ( var . flags & TLRPC . MESSAGE_FLAG_OUT ) != 0 )	if ( var . out )
final boolean var = ( var . flags & TLRPC . MESSAGE_FLAG_OUT ) == 0 && updatePrintingUsersWithNewMessages ( var . var , var )	final boolean var = ! var . out && updatePrintingUsersWithNewMessages ( var . var , var )
if ( var || var == null || var + 1500 > System . currentTimeMillis ( ) )	if ( var || var == null || Math . abs ( System . currentTimeMillis ( ) - var ) <= 1500 )
var . flags |= TLRPC . MESSAGE_FLAG_UNREAD	var . flags |= TLRPC . MESSAGE_FLAG_MEGAGROUP
if ( var . from_id <= 0 )	var . from_id = var . participant . inviter_id
var . flags |= TLRPC . MESSAGE_FLAG_CONTENT_UNREAD	var . flags |= TLRPC . MESSAGE_FLAG_MEGAGROUP
if ( var . to_id . channel_id != 0 )	if ( var != 0 )
TLRPC . Chat var = var . get ( var . to_id . channel_id )	TLRPC . Chat var = var . get ( var )
var . setIsRead ( )	Integer var = var . get ( var )
var . setContentIsRead ( )	var = MessagesStorage . getInstance ( ) . getChannelReadInboxMax ( var . channel_id )
if ( var && ( ! var . isOut ( ) && ( var . isUnread ( ) && var . to_id . channel_id == 0 || var . isContentUnread ( ) ) ) )	if ( ! var . isOut ( ) && ( var . isUnread ( ) && var . to_id . channel_id == 0 || var . isContentUnread ( ) ) )
var . flags = TLRPC . MESSAGE_FLAG_UNREAD | TLRPC . MESSAGE_FLAG_HAS_FROM_ID	var . unread = false
var . flags = TLRPC . MESSAGE_FLAG_UNREAD | TLRPC . MESSAGE_FLAG_HAS_FROM_ID	var . flags = TLRPC . MESSAGE_FLAG_HAS_FROM_ID
MessageObject var = new MessageObject ( var , var , true )	MessageObject var = new MessageObject ( var , var , var , true )
MessageObject var = new MessageObject ( var , var , true )	MessageObject var = new MessageObject ( var , var , var , true )
MessagesStorage . getInstance ( ) . updateChatInfo ( var . chat_id , var . user_id , false , var . inviter_id , var . version )	MessagesStorage . getInstance ( ) . updateChatInfo ( var . chat_id , var . user_id , 0 , var . inviter_id , var . version )
MessagesStorage . getInstance ( ) . updateChatInfo ( var . chat_id , var . user_id , true , 0 , var . version )	MessagesStorage . getInstance ( ) . updateChatInfo ( var . chat_id , var . user_id , 1 , 0 , var . version )
var . flags = TLRPC . MESSAGE_FLAG_UNREAD | TLRPC . MESSAGE_FLAG_HAS_FROM_ID	var . unread = true
MessageObject var = new MessageObject ( var , var , true )	MessageObject var = new MessageObject ( var , var , var , true )
for ( int var = 0 ; var < var . size ( ) ; var ++ )	for ( int var = 0 ; var < var . var . size ( ) ; var ++ )
if ( var . action instanceof TLRPC . TL_messageActionChatDeleteUser )	if ( var . action instanceof TLRPC . TL_messageActionChatDeleteUser . action instanceof TLRPC . TL_messageActionChatMigrateTo || var . action instanceof TLRPC . TL_messageActionChannelCreate )
if ( var != null && ( var . flags & TLRPC . USER_FLAG_BOT ) != 0 )	if ( var != null && var . bot . action . user_id == UserConfig . getClientUserId ( ) )
MessagesStorage . getInstance ( ) . applyNewChannelsGroups ( var )	MessagesStorage . getInstance ( ) . updateChatInfo ( var . chat_id , var . user_id , 1 , 0 , var . version )
if ( var == null && var instanceof TLRPC . TL_channel && ( var . flags & TLRPC . CHAT_FLAG_USER_LEFT ) == 0 )	if ( var == null && var instanceof TLRPC . TL_channel && ! var . left . left && var != null )
if ( var . messageOwner . to_id . channel_id == 0 || var . isImportant ( ) = var )	if ( var . messageOwner . to_id . channel_id == 0 || var . isMegagroup ( ) || var . isImportant ( ) = var )
if ( var != null && ( var . flags & TLRPC . CHAT_FLAG_USER_LEFT ) != 0 )	if ( var != null && var . left )
if ( var instanceof TLRPC . TL_dialog instanceof TLRPC . TL_dialogChannel ++ )	if ( var instanceof TLRPC . TL_dialog instanceof TLRPC . TL_dialogChannel )
if ( var < 25 )	if ( var < 27 )
var . add ( - var )	if ( ! var . contains ( - var ) )
var . add ( var )	if ( ! var . contains ( var ) )
getUsersInternal ( TextUtils . join ( "" , var ) , var , var )	getChatsInternal ( TextUtils . join ( "" , var ) , var , var )
getChatsInternal ( TextUtils . join ( "" , var ) , var , var )	getUsersInternal ( TextUtils . join ( "" , var ) , var , var )
if ( var != null && ( var . flags & TLRPC . CHAT_FLAG_USER_LEFT ) != 0 )	if ( var != null && ( var . left || var . migrated_to != null ) )
NotificationCenter . getInstance ( ) . postNotificationName ( NotificationCenter . chatInfoDidLoaded , var )	NotificationCenter . getInstance ( ) . postNotificationName ( NotificationCenter . chatInfoDidLoaded , var , 0 , false )
TLRPC . TL_chatParticipant var = var . participants . participants . get ( var )	TLRPC . ChatParticipant var = var . participants . participants . get ( var )
NotificationCenter . getInstance ( ) . postNotificationName ( NotificationCenter . chatInfoDidLoaded , var )	NotificationCenter . getInstance ( ) . postNotificationName ( NotificationCenter . chatInfoDidLoaded , var , 0 , false )
if ( var instanceof TLRPC . TL_chatFull )	if ( var instanceof TLRPC . TL_chatFull instanceof TLRPC . TL_channelFull )
TLRPC . TL_chatParticipant var = var . participants . participants . get ( var )	TLRPC . ChatParticipant var = var . participants . participants . get ( var )
MessagesController . getInstance ( ) . processChatInfo ( var , var , var , true , var )	MessagesController . getInstance ( ) . processChatInfo ( var , var , var , true , var , var )
var . bindLong ( 2 , var )	var . bindLong ( 3 , var )
var . add ( - var )	if ( ! var . contains ( - var ) )
var . add ( var )	if ( ! var . contains ( var ) )
if ( var . action != null && var . action . user_id != 0 && ! var . contains ( var . action . user_id ) )	var . ttl = var . intValue ( 9 )
if ( var . media != null && var . media . audio != null && var . media . audio . user_id != 0 && ! var . contains ( var . media . audio . user_id ) )	if ( var . media . audio != null && var . media . audio . user_id != 0 && ! var . contains ( var . media . audio . user_id ) )
if ( var . media != null && var . media . user_id != 0 )	if ( var . media . user_id != 0 && ! var . contains ( var . media . user_id ) )
if ( var . media != null && var . media . audio != null && var . media . audio . user_id != 0 )	if ( var . media . audio != null && var . media . audio . user_id != 0 && ! var . contains ( var . media . audio . user_id ) )
var . add ( var . fwd_from_id . channel_id )	var . add ( - var )
var . add ( var . replyMessage . action . user_id )	addUsersAndChatsFromMessage ( var . replyMessage , var , var )
var . add ( var . replyMessage . fwd_from_id . channel_id )	var . add ( - var )
var . add ( var . from_id )	if ( var . from_id != 0 )
var . add ( var . action . user_id )	if ( var . action . user_id != 0 && ! var . contains ( var . action . user_id ) )
var . add ( var . media . user_id )	if ( var . media . user_id != 0 && ! var . contains ( var . media . user_id ) )
if ( var . media != null && var . media . audio != null && var . media . audio . user_id != 0 )	if ( var . media != null )
var . add ( var . media . audio . user_id )	if ( var . media . audio != null && var . media . audio . user_id != 0 && ! var . contains ( var . media . audio . user_id ) )
var . add ( var . fwd_from_id . channel_id )	var . add ( var . action . channel_id )
var . append ( var )	var . add ( var )
if ( var . length ( ) != 0 )	if ( ! var . isEmpty ( ) )
getUsersInternal ( var . toString ( ) , var . users )	getUsersInternal ( TextUtils . join ( "" , var ) , var , var . users )
MessagesController . getInstance ( ) . processLoadedMessages ( var , var , var , var , true , var , var , var , var , var , var , var , var )	MessagesController . getInstance ( ) . processLoadedMessages ( var , var , var , var , true , var , var , var , var , var , var , var , var , var )
if ( var instanceof TLRPC . TL_message_secret && ( var . media instanceof TLRPC . TL_messageMediaPhoto && var . ttl != 0 && var . ttl <= 60 || var . media instanceof TLRPC . TL_messageMediaAudio || var . media instanceof TLRPC . TL_messageMediaVideo ) . media instanceof TLRPC . TL_messageMediaPhoto || var . media instanceof TLRPC . TL_messageMediaVideo )	if ( var instanceof TLRPC . TL_message_secret && ( var . media instanceof TLRPC . TL_messageMediaPhoto && var . ttl > 0 && var . ttl <= 60 || var . media instanceof TLRPC . TL_messageMediaAudio || var . media instanceof TLRPC . TL_messageMediaVideo ) . media instanceof TLRPC . TL_messageMediaPhoto || var . media instanceof TLRPC . TL_messageMediaVideo )
if ( var . to_id . channel_id == 0 || MessageObject . isImportant ( var ) . to_id . channel_id != 0 )	if ( var . to_id . channel_id == 0 || MessageObject . isMegagroup ( var ) || MessageObject . isImportant ( var ) . to_id . channel_id != 0 )
if ( var . reply_markup != null && ( ( var . reply_markup . flags & 4 ) == 0 || ( var . flags & 16 ) != 0 ) )	if ( var . reply_markup != null && ( ! var . reply_markup . selective || var . mentioned ) )
if ( ( var . to_id . channel_id == 0 || MessageObject . isImportant ( var ) ) && var . date >= ConnectionsManager . getInstance ( ) . getCurrentTime - 60 * 60 * 24 && var != 0 )	if ( ( var . to_id . channel_id == 0 || MessageObject . isImportant ( var ) ) && var . date >= ConnectionsManager . getInstance ( ) . getCurrentTime - 60 * 60 && var != 0 )
var . bindInteger ( 5 , 0 )	var . bindInteger ( 5 , var )
long var = var . get ( var )	var . add ( ( long ) - var )
var |= ( ( long ) var ) << 32	var . add ( ( long ) - var )
var . append ( ',' )	var = var . executeFast ( "" )
var = var . toString ( )	var = TextUtils . join ( "" , var )
var = TextUtils . join ( "" , var )	var = var . executeFast ( "" )
if ( var == 0 && var . reply_markup != null && ( ( var . reply_markup . flags & 4 ) == 0 || ( var . flags & 16 ) != 0 ) )	if ( var == 0 && var . reply_markup != null && ( ! var . reply_markup . selective || var . mentioned ) )
if ( ! var . contains ( var . action . user_id ) )	if ( var . action . user_id != 0 && ! var . contains ( var . action . user_id ) )
MessagesController . getInstance ( ) . processLoadedDialogs ( var , var , var , var , var , var , true , false , false )	MessagesController . getInstance ( ) . processLoadedDialogs ( var , var , var , var , true , false , false )
if ( MessageObject . isImportant ( var ) || var . to_id . channel_id == 0 )	if ( var . to_id . channel_id == 0 || MessageObject . isMegagroup ( var ) || MessageObject . isImportant ( var ) . to_id . channel_id != 0 )
var = var . date	var = Math . max ( var . date , var )
var = var . date	var = Math . max ( var . date , var )
if ( var . reply_markup != null && ( ( var . reply_markup . flags & 4 ) == 0 || ( var . flags & 16 ) != 0 ) )	if ( var . reply_markup != null && ( ! var . reply_markup . selective || var . mentioned ) )
var = var . id	var = Math . max ( var . id , var )
var = var . id	var = Math . max ( var . id , var )
if ( var != 0 && var == 0 )	if ( var . size ( ) == 1 . size ( ) == 2 )
if ( var < var )	if ( var != 0 && var < var )
DefaultHttpClient var = new DefaultHttpClient	SimpleMultipartEntity var = new SimpleMultipartEntity
HttpPost var = new HttpPost ( "" + var + "" )	HttpURLConnection var = ( HttpURLConnection ) new URL ( "" + var + "" ) . openConnection
File var = new File ( Constants . FILES_PATH , var )	Uri var = Uri . fromFile ( new File ( Constants . FILES_PATH , var ) . FILES_PATH , var )
var . addPart ( "" , new FileBody ( var ) )	var . addPart ( "" , var . getLastPathSegment ( ) , var , false )
var . addPart ( "" , new FileBody ( var ) )	var . addPart ( "" , var . getLastPathSegment ( ) , var , false )
var . setEntity ( var )	var . setRequestProperty ( "" , var . getContentType ( ) )
FileLog . var ( "" , var )	var . printStackTrace ( )
if ( ( var . messageOwner . flags & TLRPC . MESSAGE_FLAG_MENTION ) != 0 )	if ( var . messageOwner . mentioned )
if ( ( var . messageOwner . flags & TLRPC . MESSAGE_FLAG_MENTION ) != 0 )	if ( var . messageOwner . mentioned )
String var = LocaleController . formatString ( "" , R . string . formatDateAtTime , LocaleController . formatterYear . format ( ( ( long ) var . messageOwner . var ) * 1000 ) ( long ) var . messageOwner . var ) * 1000 , LocaleController . formatterDay . format ( ( ( long ) var . messageOwner . var ) * 1000 ) ( long ) var . messageOwner . var ) * 1000 )	String var = LocaleController . formatString ( "" , R . string . formatDateAtTime , LocaleController . getInstance ( ) . formatterYear . format ( ( ( long ) var . messageOwner . var ) * 1000 ) ( long ) var . messageOwner . var ) * 1000 , LocaleController . getInstance ( ) . formatterDay . format ( ( ( long ) var . messageOwner . var ) * 1000 ) ( long ) var . messageOwner . var ) * 1000 )
if ( var . messageOwner . to_id . channel_id != 0 )	if ( var . messageOwner . to_id . channel_id != 0 && ! var . isMegagroup ( ) )
if ( var . messageOwner . action . user_id == UserConfig . getClientUserId ( ) )	if ( var == UserConfig . getClientUserId ( ) )
if ( var . messageOwner . to_id . channel_id != 0 )	if ( var . messageOwner . to_id . channel_id != 0 && ! var . isMegagroup ( ) )
if ( ChatObject . isChannel ( var ) )	if ( ChatObject . isChannel ( var ) && ! var . megagroup )
if ( var > System . currentTimeMillis ( ) - 500 )	if ( Math . abs ( System . currentTimeMillis ( ) - var ) <= 500 )
if ( ( var . messageOwner . flags & TLRPC . MESSAGE_FLAG_MENTION ) != 0 )	if ( var . messageOwner . mentioned )
if ( ! ChatObject . isChannel ( var ) )	if ( ! ChatObject . isChannel ( var ) && ! AndroidUtilities . needShowPasscode ( false ) && ! UserConfig . isWaitingForPasscodeEnter )
if ( var > System . currentTimeMillis ( ) - 100 )	if ( Math . abs ( System . currentTimeMillis ( ) - var ) <= 100 )
var . flags = TLRPC . MESSAGE_FLAG_UNREAD | TLRPC . MESSAGE_FLAG_OUT | TLRPC . MESSAGE_FLAG_HAS_FROM_ID	var . flags = TLRPC . MESSAGE_FLAG_HAS_FROM_ID
var . flags = TLRPC . MESSAGE_FLAG_UNREAD | TLRPC . MESSAGE_FLAG_HAS_MEDIA | TLRPC . MESSAGE_FLAG_HAS_FROM_ID	var . flags = TLRPC . MESSAGE_FLAG_HAS_MEDIA | TLRPC . MESSAGE_FLAG_HAS_FROM_ID
var . flags = TLRPC . MESSAGE_FLAG_UNREAD | TLRPC . MESSAGE_FLAG_HAS_FROM_ID	var . flags = TLRPC . MESSAGE_FLAG_HAS_FROM_ID
sendMessage ( null , null , null , null , null , null , var , null , null , null , var , false , null , var , null , true , var )	sendMessage ( null , null , null , null , null , var , null , null , null , var , null , var , null , true , var , null )
TLRPC . InputPeer var = MessagesController . getInputPeer ( ( int ) var )	TLRPC . InputPeer var = MessagesController . getInputPeer ( var )
var . flags |= TLRPC . MESSAGE_FLAG_OUT	var . flags |= TLRPC . MESSAGE_FLAG_MEGAGROUP
if ( var && var . channel_id != 0 )	if ( var && var . channel_id != 0 && ! var )
var . flags |= TLRPC . MESSAGE_FLAG_CONTENT_UNREAD	var . ttl = - var . messageOwner . var . channel_id
var . flags |= TLRPC . MESSAGE_FLAG_UNREAD	var . unread = true
if ( var . size ( ) == 100 || var == var . size ( ) - 1 )	if ( var . size ( ) == 100 || var == var . size ( ) - 1 || var != var . size ( ) - 1 && var . get ( var + 1 ) . getDialogId != var . getDialogId ( ) )
if ( var && var . to_peer . channel_id != 0 )	if ( var && var . to_peer . channel_id != 0 && ! var )
var . flags |= 16	var . broadcast = true
sendMessage ( null , null , null , null , null , var , null , null , null , null , var . getDialogId ( ) , true , var . messageOwner . attachPath , null , null , true , var )	sendMessage ( null , null , null , null , null , null , null , null , null , var . getDialogId ( ) , var . messageOwner . attachPath , null , null , true , var , var )
sendMessage ( null , null , null , null , null , null , null , var , null , var , var , false , var , var , null , true , var )	sendMessage ( null , null , null , null , null , null , var , null , var , var , var , var , null , true , var , null )
sendMessage ( var , null , null , null , null , null , null , null , null , null , var , false , null , var , var , var , var )	sendMessage ( var , null , null , null , null , null , null , null , null , var , null , var , var , var , var , null )
sendMessage ( null , var , null , null , null , null , null , null , null , null , var , false , null , var , null , true , var )	sendMessage ( null , var , null , null , null , null , null , null , null , var , null , var , null , true , var , null )
sendMessage ( null , null , var , null , null , null , null , null , null , var , var , false , var , var , null , true , var )	sendMessage ( null , null , var , null , null , null , null , null , var , var , var , var , null , true , var , null )
sendMessage ( null , null , null , var , var , null , null , null , null , var , var , false , var , var , null , true , var )	sendMessage ( null , null , null , var , var , null , null , null , var , var , var , var , null , true , var , null )
sendMessage ( null , null , null , null , null , null , null , null , var , null , var , false , var , var , null , true , var )	sendMessage ( null , null , null , null , null , null , null , var , null , var , var , var , null , true , var , null )
if ( var . isForwarded ( ) = 4 )	if ( var . var == 1 )
if ( var . isForwarded ( ) = 4 )	if ( var . var == 3 )
var . flags |= TLRPC . MESSAGE_FLAG_OUT	var . out = true
var . flags |= TLRPC . MESSAGE_FLAG_CONTENT_UNREAD	var . media_unread = true
var . flags |= TLRPC . MESSAGE_FLAG_UNREAD	var . unread = true
if ( ( var . flags & TLRPC . USER_FLAG_BOT ) != 0 )	if ( var . bot )
var . flags &= ~ TLRPC . MESSAGE_FLAG_UNREAD	var . unread = false
var . flags |= 16	var . broadcast = true
var . flags |= 2	var . no_webpage = true
var . flags |= 16	var . broadcast = true
TLRPC . TL_messages_forwardMessage var = new TLRPC . TL_messages_forwardMessage ( )	TLRPC . TL_messages_forwardMessages var = new TLRPC . TL_messages_forwardMessages ( )
var . var = var	var . to_peer = var
var . random_id = var . random_id	var . random_id . add ( var . random_id )
var . id = var . getId ( )	var . id . add ( var . getId ( ) )
var . id = var . messageOwner . fwd_msg_id	var . id . add ( var . messageOwner . fwd_msg_id )
SQLiteCursor var = MessagesStorage . getInstance ( ) . getDatabase . queryFinalized ( String . format ( Locale . US , "" , 0 , 20 ) . US , "" , 0 , 20 )	SQLiteCursor var = MessagesStorage . getInstance ( ) . getDatabase . queryFinalized ( String . format ( Locale . US , "" , 0 , 30 ) . US , "" , 0 , 30 )
var . putBoolean ( "" , var )	var . putInt ( "" , var )
var = var . getBoolean ( "" , false )	var = var . getInt ( "" , 0 )
var = false	var = - 1
return var == null || var instanceof TLRPC . TL_userDeleted_old2 || var instanceof TLRPC . TL_userEmpty || ( var . flags & TLRPC . USER_FLAG_DELETED ) != 0	return var == null || var instanceof TLRPC . TL_userDeleted_old2 || var instanceof TLRPC . TL_userEmpty || var . deleted
return var instanceof TLRPC . TL_userContact_old2 || ( var . flags & TLRPC . USER_FLAG_CONTACT ) != 0 || ( var . flags & TLRPC . USER_FLAG_MUTUAL_CONTACT ) != 0	return var instanceof TLRPC . TL_userContact_old2 || var . contact || var . mutual_contact
return var instanceof TLRPC . TL_userSelf_old3 || ( var . flags & TLRPC . USER_FLAG_SELF ) != 0	return var instanceof TLRPC . TL_userSelf_old3 || var . self
MessagesController . getInstance ( ) . markDialogAsRead ( var , var , var , 0 , 0 , true , false )	MessagesController . getInstance ( ) . markDialogAsRead ( var , var , var , 0 , true , false )
if ( var < var . size ( ) - 1 |= 1 )	if ( var < var . size ( var ) - 1 || ! messagesSearchEndReached [ 0 ] || ! messagesSearchEndReached [ 1 ] |= 1 )
if ( var == null || var . length ( ) == 0 )	if ( var == null || var . length ( var ) == 0 )
if ( var < var . size ( ) )	if ( var < var . size ( var ) var )
NotificationCenter . getInstance ( ) . postNotificationName ( NotificationCenter . chatSearchResultsAvailable , var , var . get ( var ) . getId , getMask )	NotificationCenter . getInstance ( var ) . postNotificationName ( NotificationCenter . chatSearchResultsAvailable , var , var . getId ( var ) , getMask var , var . getDialogId ( var ) )
var = var . get ( var . size ( ) - 1 ) . getId	MessageObject var = var . get ( var . size ( var ) - 1 )
NotificationCenter . getInstance ( ) . postNotificationName ( NotificationCenter . chatSearchResultsAvailable , var , var . get ( var ) . getId , getMask )	NotificationCenter . getInstance ( var ) . postNotificationName ( NotificationCenter . chatSearchResultsAvailable , var , var . getId ( var ) , getMask var , var . getDialogId ( var ) )
if ( var . var == 0 )	if ( var . var == 0 && var == var )
if ( var . isEmpty ( ) )	if ( var . isEmpty ( var ) var )
NotificationCenter . getInstance ( ) . postNotificationName ( NotificationCenter . chatSearchResultsAvailable , var , 0 , getMask )	NotificationCenter . getInstance ( var ) . postNotificationName ( NotificationCenter . chatSearchResultsAvailable , var , var . getId ( var ) , getMask var , var . getDialogId ( var ) )
NotificationCenter . getInstance ( ) . postNotificationName ( NotificationCenter . chatSearchResultsAvailable , var , var . get ( var ) . getId , getMask )	NotificationCenter . getInstance ( var ) . postNotificationName ( NotificationCenter . chatSearchResultsAvailable , var , 0 , getMask var , ( long ) 0 )
if ( var . media != null && var . media . audio != null && var . media . audio . user_id != 0 )	MessagesStorage . addUsersAndChatsFromMessage ( var , var , var )
if ( ! var . contains ( var . media . audio . user_id ) )	MessagesStorage . addUsersAndChatsFromMessage ( var , var , var )
MessageObject var = new MessageObject ( var , var , false )	MessageObject var = new MessageObject ( var , var , var , false )
if ( var != null && ( var . set . flags & 2 ) != 0 )	if ( var != null && var . set . disabled )
var . set . flags = var . flags	var . set . disabled = var . disabled
if ( var != null )	if ( var != null var )
if ( ( var . set . flags & 2 ) == 0 )	if ( ! var . set . disabled )
var . flags &= ~ 2	var . disabled = var == 1
final int var = var ++	final int var = var . getAndIncrement ( )
FileLog . d ( "" , "" + var )	FileLog . d ( "" , "" + var + "" + var )
self_participant = TL_chatParticipant . TLdeserialize ( var , var . readInt32 ( var ) , var )	ChatParticipant var = ChatParticipant . TLdeserialize ( var , var . readInt32 ( var ) , var )
TL_chatParticipant var = TL_chatParticipant . TLdeserialize ( var , var . readInt32 ( var ) , var )	self_participant = ChatParticipant . TLdeserialize ( var , var . readInt32 ( var ) , var )
if ( var )	if ( var == null && var )
TL_chatParticipant var = new TL_chatParticipant	var = new TL_chatParticipant
var . readParams ( var , var )	return TL_messages_affectedMessages . TLdeserialize ( var , var , var )
if ( ( flags & 512 ) != 0 )	if ( ( flags & 64 ) != 0 )
media = MessageMedia . TLdeserialize ( var , var . readInt32 ( var ) , var )	migrated_to = InputChannel . TLdeserialize ( var , var . readInt32 ( var ) , var )
media = new TL_messageMediaEmpty	flags = var . readInt32 ( var )
return TL_messages_affectedHistory . TLdeserialize ( var , var , var )	return Updates . TLdeserialize ( var , var , var )
var . get ( var ) . serializeToStream ( var )	var . writeString ( var )
var . writeBool ( ( flags & var ) != 0 )	unread = ( flags & 1 ) != 0
var . writeBool ( ( flags & var ) != 0 )	out = ( flags & 2 ) != 0
var . writeBool ( ( flags & var ) != 0 )	var . writeBool ( out )
removeFragmentFromStack ( var . get ( var ) )	removeFragmentFromStackInternal ( var . get ( var ) )
public BottomSheet ( Context var )	public BottomSheet ( Context var , boolean var )
if ( Build . VERSION . SDK_INT >= 21 )	if ( Build . VERSION . SDK_INT >= 21 && ! var )
var = new BottomSheet ( var )	var = new BottomSheet ( var , false )
var = new UserCell ( var , 58 )	var = new UserCell ( var , 58 , 1 )
return var != getItemCount	return var != getItemCount || var == 1
final TLRPC . TL_messages_search var = new TLRPC . TL_messages_search ( )	final TLRPC . TL_messages_searchGlobal var = new TLRPC . TL_messages_searchGlobal ( )
var . peer = new TLRPC . TL_inputPeerEmpty ( )	var . offset_peer = new TLRPC . TL_inputPeerEmpty ( )
var . max_id = var . get ( var . size ( ) - 1 ) . getId	MessageObject var = var . get ( var . size ( ) - 1 )
var . filter = new TLRPC . TL_inputMessagesFilterEmpty ( )	var . offset_peer = MessagesController . getInputPeer ( var )
if ( var . max_id == 0 )	if ( var . offset_id == 0 )
return var . get ( var - 1 ) . object	TLObject var = var . get ( var - 1 ) . var
if ( var instanceof TLRPC . TL_chatFull )	if ( var . participants != null )
var . add ( MessagesController . getInstance ( ) . getUser ( var . getValue ( ) . user_id ) . getValue ( ) . user_id )	var . add ( MessagesController . getInstance ( ) . getUser ( var . user_id ) . user_id )
if ( var != null && var != 1 )	if ( var . get ( var ) != null )
public SearchAdapter ( Context var , HashMap < Integer , TLRPC . User > , TLRPC . User var , boolean var , boolean var , boolean var )	public SearchAdapter ( Context var , HashMap < Integer , TLRPC . User > , TLRPC . User var , boolean var , boolean var , boolean var , boolean var )
queryServerSearch ( null , var )	queryServerSearch ( null , var , var )
queryServerSearch ( var , var )	queryServerSearch ( var , var , var )
if ( var . id == UserConfig . getClientUserId ( var ) || var && ( var . flags & TLRPC . USER_FLAG_MUTUAL_CONTACT ) == 0 )	if ( var . id == UserConfig . getClientUserId ( var ) || var && ! var . mutual_contact )
var = new UserCell ( var , 1 )	var = new UserCell ( var , 1 , 1 )
var . flags = TLRPC . MESSAGE_FLAG_OUT	var . out = true
var = new UserCell ( var , 1 )	var = new UserCell ( var , 1 , 0 )
var = LocaleController . formatterDay . format ( long ( var . messageOwner . date ) . messageOwner . date * 1000 )	var = LocaleController . getInstance ( ) . formatterDay . format ( long ( var . messageOwner . date ) . messageOwner . date * 1000 )
var = LocaleController . formatterDay . format ( long ( var . messageOwner . date ) . messageOwner . date * 1000 )	var = LocaleController . getInstance ( ) . formatterDay . format ( long ( var . messageOwner . date ) . messageOwner . date * 1000 )
if ( var . getLineCount ( ) > 0 = 0 )	if ( var != null && var . getLineCount ( ) > 0 = 0 )
if ( var >= var && var <= var + Math . max ( var , var ) && var >= var && var <= var + AndroidUtilities . dp ( 35 ) )	if ( var . isReply ( ) && var >= var && var <= var + Math . max ( var , var ) && var >= var && var <= var + AndroidUtilities . dp ( 35 ) )
if ( var . getLineCount ( ) > 0 = var )	if ( var != null && var . getLineCount ( ) > 0 = var )
if ( var . getLineCount ( ) > 0 )	if ( var != null && var . getLineCount ( ) > 0 )
if ( var == 0 && var == 0 )	if ( var == 0 )
var = new TextPaint ( TextPaint . ANTI_ALIAS_FLAG )	var = getResources . getDrawable ( R . drawable . bot_list )
var . setTextSize ( AndroidUtilities . dp ( 17 ) )	var = AndroidUtilities . dp ( 16.5f )
var . setColor ( 0xff4d83b3 )	var = getResources . getDrawable ( R . drawable . bot_list )
var . setTypeface ( AndroidUtilities . getTypeface ( "" ) )	var = getResources . getDrawable ( R . drawable . bot_list )
if ( var . id < 0 || var instanceof TLRPC . TL_channel || var instanceof TLRPC . TL_channelForbidden )	if ( var . id < 0 || ChatObject . isChannel ( var ) && ! var . megagroup )
var = ( var . flags & TLRPC . CHAT_FLAG_IS_VERIFIED ) != 0	var = var . verified
var = Emoji . replaceEmoji ( AndroidUtilities . replaceTags ( String . format ( "" , var , var ) , var , var , AndroidUtilities . FLAG_TAG_COLOR ) . format ( "" , var , var ) , var , var , AndroidUtilities . FLAG_TAG_COLOR , var . getFontMetricsInt ( ) , AndroidUtilities . dp ( 20 ) , false )	var = Emoji . replaceEmoji ( AndroidUtilities . replaceTags ( String . format ( "" , var . replace ( "" , "" ) , "" , var ) , var . replace ( "" , "" ) , "" , var , AndroidUtilities . FLAG_TAG_COLOR ) . format ( "" , var . replace ( "" , "" ) , "" , var ) , var . replace ( "" , "" ) , "" , var , AndroidUtilities . FLAG_TAG_COLOR , var . getFontMetricsInt ( ) , AndroidUtilities . dp ( 20 ) , false )
var = Emoji . replaceEmoji ( AndroidUtilities . replaceTags ( String . format ( "" , var , var . messageText ) , var , var . messageText , AndroidUtilities . FLAG_TAG_COLOR ) . format ( "" , var , var . messageText ) , var , var . messageText , AndroidUtilities . FLAG_TAG_COLOR , var . getFontMetricsInt ( ) , AndroidUtilities . dp ( 20 ) , false )	var = Emoji . replaceEmoji ( AndroidUtilities . replaceTags ( String . format ( "" , var . replace ( "" , "" ) , "" , var . messageText ) , var . replace ( "" , "" ) , "" , var . messageText , AndroidUtilities . FLAG_TAG_COLOR ) . format ( "" , var . replace ( "" , "" ) , "" , var . messageText ) , var . replace ( "" , "" ) , "" , var . messageText , AndroidUtilities . FLAG_TAG_COLOR , var . getFontMetricsInt ( ) , AndroidUtilities . dp ( 20 ) , false )
var = Emoji . replaceEmoji ( AndroidUtilities . replaceTags ( String . format ( "" , var , var ) , var , var , AndroidUtilities . FLAG_TAG_COLOR ) . format ( "" , var , var ) , var , var , AndroidUtilities . FLAG_TAG_COLOR , var . getFontMetricsInt ( ) , AndroidUtilities . dp ( 20 ) , false )	var = Emoji . replaceEmoji ( AndroidUtilities . replaceTags ( String . format ( "" , var . replace ( "" , "" ) , "" , var ) , var . replace ( "" , "" ) , "" , var , AndroidUtilities . FLAG_TAG_COLOR ) . format ( "" , var . replace ( "" , "" ) , "" , var ) , var . replace ( "" , "" ) , "" , var , AndroidUtilities . FLAG_TAG_COLOR , var . getFontMetricsInt ( ) , AndroidUtilities . dp ( 20 ) , false )
if ( var != var . id || var != null && var . getId ( ) != var . top_message || var != var . unread_count )	if ( var != var . id || var != null && var . getId ( ) != var . top_message || var != var . unread_count || var == null && MessagesController . getInstance ( ) . dialogMessage . get ( var . id ) != null )
if ( ChatObject . isChannel ( var ) )	if ( ChatObject . isChannel ( var ) && ! var . megagroup )
var = ( var . flags & TLRPC . CHAT_FLAG_IS_VERIFIED ) != 0	var = var . verified
if ( ( var . flags & TLRPC . USER_FLAG_BOT ) != 0 )	if ( var . bot )
if ( var != null )	if ( var != null && ! var )
var . setText ( String . format ( "" , AndroidUtilities . formatFileSize ( var . messageOwner . media . var . size ) . messageOwner . media . var . size , LocaleController . formatString ( "" , R . string . formatDateAtTime , LocaleController . formatterYear . format ( new Date ( var ) ) Date ( var ) , LocaleController . formatterDay . format ( new Date ( var ) ) Date ( var ) ) , R . string . formatDateAtTime , LocaleController . formatterYear . format ( new Date ( var ) ) Date ( var ) , LocaleController . formatterDay . format ( new Date ( var ) ) Date ( var ) ) , AndroidUtilities . formatFileSize ( var . messageOwner . media . var . size ) . messageOwner . media . var . size , LocaleController . formatString ( "" , R . string . formatDateAtTime , LocaleController . formatterYear . format ( new Date ( var ) ) Date ( var ) , LocaleController . formatterDay . format ( new Date ( var ) ) Date ( var ) ) , R . string . formatDateAtTime , LocaleController . formatterYear . format ( new Date ( var ) ) Date ( var ) , LocaleController . formatterDay . format ( new Date ( var ) ) Date ( var ) )	var . setText ( String . format ( "" , AndroidUtilities . formatFileSize ( var . messageOwner . media . var . size ) . messageOwner . media . var . size , LocaleController . formatString ( "" , R . string . formatDateAtTime , LocaleController . getInstance ( var ) . formatterYear . format ( new Date ( var ) ) Date ( var ) , LocaleController . getInstance ( var ) . formatterDay . format ( new Date ( var ) ) Date ( var ) ) , R . string . formatDateAtTime , LocaleController . getInstance ( var ) . formatterYear . format ( new Date ( var ) ) Date ( var ) , LocaleController . getInstance ( var ) . formatterDay . format ( new Date ( var ) ) Date ( var ) ) , AndroidUtilities . formatFileSize ( var . messageOwner . media . var . size ) . messageOwner . media . var . size , LocaleController . formatString ( "" , R . string . formatDateAtTime , LocaleController . getInstance ( var ) . formatterYear . format ( new Date ( var ) ) Date ( var ) , LocaleController . getInstance ( var ) . formatterDay . format ( new Date ( var ) ) Date ( var ) ) , R . string . formatDateAtTime , LocaleController . getInstance ( var ) . formatterYear . format ( new Date ( var ) ) Date ( var ) , LocaleController . getInstance ( var ) . formatterDay . format ( new Date ( var ) ) Date ( var ) )
if ( ( var . var . flags & 2 ) != 0 )	if ( var . var . disabled )
public UserCell ( Context var , int var )	public UserCell ( Context var , int var , int var )
if ( ( var . flags & TLRPC . USER_FLAG_BOT ) != 0 )	if ( var . bot )
if ( ( var . flags & TLRPC . USER_FLAG_BOT_READING_HISTORY ) != 0 )	if ( var . bot_chat_history )
var . width = LayoutHelper . MATCH_PARENT	addView ( var , LayoutHelper . createLinear ( LayoutHelper . MATCH_PARENT , 36 , 20 , 0 , 20 , 14 ) . MATCH_PARENT , 36 , 20 , 0 , 20 , 14 )
var . height = AndroidUtilities . dp ( 36 )	addView ( var , LayoutHelper . createLinear ( LayoutHelper . MATCH_PARENT , 1 , 24 , - 17.5f , 24 , 0 ) . MATCH_PARENT , 1 , 24 , - 17.5f , 24 , 0 )
var . rightMargin = AndroidUtilities . dp ( 20 )	addView ( var , LayoutHelper . createLinear ( LayoutHelper . MATCH_PARENT , LayoutHelper . WRAP_CONTENT , 0 , 20 , 0 , 0 ) . MATCH_PARENT , LayoutHelper . WRAP_CONTENT , 0 , 20 , 0 , 0 )
var . leftMargin = AndroidUtilities . dp ( 24 )	var . addView ( var , LayoutHelper . createLinear ( 55 , 36 , - 9 , 0 , 16 , 0 ) , 36 , - 9 , 0 , 16 , 0 )
var . rightMargin = AndroidUtilities . dp ( 24 )	var . addView ( var , LayoutHelper . createLinear ( LayoutHelper . MATCH_PARENT , 36 , 0 , 0 , 24 , 0 ) . MATCH_PARENT , 36 , 0 , 0 , 24 , 0 )
var . width = LayoutHelper . MATCH_PARENT	if ( var . charAt ( var ) == ' ' && var > 0 = 2 )
var . topMargin = AndroidUtilities . dp ( 20 )	var = var - 1
var . setLayoutParams ( var )	int var = var . getSelectionStart ( )
var [ 0 ] = new InputFilter . LengthFilter ( 4 )	var [ 0 ] = new InputFilter . LengthFilter ( 5 )
var = ( LayoutParams ) var . getLayoutParams ( )	String var = var . getText ( ) . toString
var . setLayoutParams ( var )	for ( int var = 0 ; var < var . length ( ) ; var ++ )
if ( var != null )	if ( var != - 1 )
if ( var != - 1 )	if ( var != null )
var = new EditText ( var )	var = new HintEditText ( var )
var . rightMargin = AndroidUtilities . dp ( 24 )	for ( int var = 0 ; var < var . length ( ) ; var ++ )
var . setLayoutParams ( var )	for ( int var = 0 ; var < var . length ( ) ; var ++ )
if ( var == 1 && var == 0 && var . length ( ) > 1 )	if ( var < var . length ( ) )
String var = var . toString ( )	String var = var . substring ( var , var + 1 )
if ( ! var . contains ( var ) )	if ( var . charAt ( var ) == ' ' )
StringBuilder var = new StringBuilder ( var )	StringBuilder var = new StringBuilder ( var . length ( ) )
var = var . substring ( var , var + 1 )	String var = var . substring ( var , var + 1 )
var . delete ( Math . max ( 0 , var - var ) , var - var , var + 1 )	var . insert ( var , ' ' )
var . setText ( "" )	var . setText ( var )
var = ( LayoutParams ) var . getLayoutParams ( )	var . insert ( var , ' ' )
var . topMargin = AndroidUtilities . dp ( 28 )	var . onTextChange ( )
if ( ! var . equals ( var ) )	if ( var . length ( ) != 0 )
var = PhoneFormat . getInstance ( ) . format ( var . getText ( ) . toString ) . trim	String var = var . getText ( ) . toString
var . setText ( var . substring ( var ) . trim )	AndroidUtilities . showKeyboard ( var )
MessagesController . getInstance ( ) . addUsersToChannel ( var , var )	MessagesController . getInstance ( ) . addUsersToChannel ( var , var , null )
var = new SearchAdapter ( var , null , false , false , false )	var = new SearchAdapter ( var , null , false , false , false , false )
MessagesStorage . getInstance ( ) . loadChatInfo ( var , var , false )	MessagesStorage . getInstance ( ) . loadChatInfo ( var , var , false , false )
var = ( var . flags & TLRPC . CHAT_FLAG_IS_BROADCAST ) == 0	var = ! var . broadcast
boolean var = ( var . flags & TLRPC . CHAT_FLAG_IS_BROADCAST ) == 0	boolean var = ! var . broadcast
if ( var != null && ( var . flags & TLRPC . CHAT_FLAG_ADMIN ) != 0 )	if ( var . creator )
if ( var != null )	if ( var == null )
AlertsCreator . showAddUserAlert ( var . text , ChannelUsersActivity . this )	AlertsCreator . showAddUserAlert ( var . text , ChannelUsersActivity . this , ! var )
if ( var != null )	if ( var != null && ! var )
if ( var . isEmpty ( ) && var == 0 || var )	if ( var . isEmpty ( ) && var == 0 || var && ! var )
var = new UserCell ( var , 1 )	var = new UserCell ( var , 1 , 0 )
( ( TextInfoPrivacyCell ) var ) . setText ( LocaleController . getString ( "" , R . string . UnblockText ) , R . string . UnblockText )	( ( TextInfoPrivacyCell ) var ) . setText ( String . format ( "" , LocaleController . getString ( "" , R . string . NoBlockedGroup ) , R . string . NoBlockedGroup , LocaleController . getString ( "" , R . string . UnblockText ) , R . string . UnblockText ) , LocaleController . getString ( "" , R . string . NoBlockedGroup ) , R . string . NoBlockedGroup , LocaleController . getString ( "" , R . string . UnblockText ) , R . string . UnblockText )
var = Integer . MIN_VALUE	maxMessageId [ 0 ] = maxMessageId [ 1 ] = Integer . MIN_VALUE
var = Integer . MAX_VALUE	minMessageId [ 0 ] = minMessageId [ 1 ] = Integer . MAX_VALUE
if ( var != 0 )	if ( var != 0 var )
for ( int var = 0 ; var < var . participants . participants . size ( ) ; var ++ )	for ( int var = 0 ; var < var . participants . participants . size ( var ) ; var ++ )
TLRPC . TL_chatParticipant var = var . participants . participants . get ( var )	TLRPC . ChatParticipant var = var . participants . participants . get ( var )
TLRPC . User var = MessagesController . getInstance ( ) . getUser ( var . user_id )	TLRPC . User var = MessagesController . getInstance ( var ) . getUser ( var . user_id )
if ( var != null && ( var . flags & TLRPC . USER_FLAG_BOT ) != 0 )	if ( var != null && var . bot )
var . clear ( )	var [ var ] . clear var
var . clear ( )	var [ var ] . clear var
MessageObject var = var . get ( var )	MessageObject var = var [ var ] . get ( var )
var . clear ( )	var [ var ] . clear var
var . clear ( )	var [ var ] . clear var
if ( getParentActivity == null )	if ( getParentActivity var == null )
AlertDialog . Builder var = new AlertDialog . Builder ( getParentActivity )	AlertDialog . Builder var = new AlertDialog . Builder ( getParentActivity var )
if ( ! var . isEmpty ( ) )	if ( ! var . isEmpty ( var ) )
MessageObject var = var . get ( var . get ( 0 ) )	MessageObject var = var [ var ] . get ( var . get ( 0 ) )
showDialog ( var . create ( ) )	showDialog ( var . create ( var ) )
showDialog ( AndroidUtilities . buildTTLAlert ( getParentActivity , var )  , var . create )	showDialog ( AndroidUtilities . buildTTLAlert ( getParentActivity var , var ) var , var . create var )
if ( var != var )	if ( var var )
if ( ChatObject . isNotInChat ( var ) )	if ( ChatObject . isNotInChat ( var ) var )
MessagesController . getInstance ( ) . deleteDialog ( var , 0 , false )	MessagesController . getInstance ( var ) . deleteDialog ( var , true )
MessagesController . getInstance ( ) . deleteDialog ( var , 0 , false )	MessagesController . getInstance ( var ) . deleteDialog ( var , false )
MessagesController . getInstance ( ) . deleteDialog ( var , 0 , true )	MessagesController . getInstance ( var ) . deleteDialog ( var , false )
if ( var . size ( ) == 1 )	if ( var == null && var [ var ] . size var == 1 )
var . clear ( )	var [ var ] . clear var
var . clear ( )	var [ var ] . clear var
MessagesSearchQuery . searchMessagesInChat ( null , var , classGuid , 1 )	MessagesSearchQuery . searchMessagesInChat ( null , var , var , classGuid , 2 )
MessagesSearchQuery . searchMessagesInChat ( null , var , classGuid , 2 )	MessagesSearchQuery . searchMessagesInChat ( null , var , var , classGuid , 1 )
if ( var == 0 || ( var . flags & TLRPC . CHAT_FLAG_USER_LEFT ) != 0 || var instanceof TLRPC . TL_chatForbidden || var != null && var . participants instanceof TLRPC . TL_chatParticipantsForbidden )	if ( var == 0 || var . deactivated || var . left || var instanceof TLRPC . TL_chatForbidden || var != null && var . participants instanceof TLRPC . TL_chatParticipantsForbidden )
if ( ChatObject . isChannel ( var ) )	if ( ChatObject . isChannel ( var ) && ! var . megagroup && ! ( var instanceof TLRPC . TL_channelForbidden ) var )
MessagesSearchQuery . searchMessagesInChat ( var . getText ( ) . toString , var , classGuid , 0 )	MessagesSearchQuery . searchMessagesInChat ( var . getText ( var ) . toString var , var , var , classGuid , 0 )
if ( var != 0 )	if ( var != 0 && ! var . megagroup )
if ( var != null && var == null && ( var . flags & TLRPC . USER_FLAG_BOT ) != 0 )	if ( var != null && var == null && var . bot )
var . measure ( MeasureSpec . makeMeasureSpec ( var , MeasureSpec . EXACTLY ) , MeasureSpec . EXACTLY , MeasureSpec . makeMeasureSpec ( var . getLayoutParams ( ) . height , MeasureSpec . EXACTLY ) . getLayoutParams ( ) . height , MeasureSpec . EXACTLY )	var . measure ( MeasureSpec . makeMeasureSpec ( var , MeasureSpec . EXACTLY ) , MeasureSpec . EXACTLY , MeasureSpec . makeMeasureSpec ( var . getLayoutParams ( var ) . height , MeasureSpec . EXACTLY ) . getLayoutParams ( var ) . height , MeasureSpec . EXACTLY )
if ( var . size ( ) != 0 )	if ( var . size ( var ) != 0 var )
if ( var + var == var && var )	if ( var + var == var && forwardEndReached [ 0 ] )
var . addView ( var , LayoutHelper . createLinear ( LayoutHelper . MATCH_PARENT , LayoutHelper . MATCH_PARENT , 0.5f , Gravity . LEFT | Gravity . TOP , 0 , 0 , 0 , AndroidUtilities . dp ( 1 ) ) . MATCH_PARENT , LayoutHelper . MATCH_PARENT , 0.5f , Gravity . LEFT | Gravity . TOP , 0 , 0 , 0 , AndroidUtilities . dp ( 1 ) )	var . addView ( var , LayoutHelper . createLinear ( LayoutHelper . MATCH_PARENT , LayoutHelper . MATCH_PARENT , 0.5f , Gravity . LEFT | Gravity . TOP ) . MATCH_PARENT , LayoutHelper . MATCH_PARENT , 0.5f , Gravity . LEFT | Gravity . TOP )
if ( ( var . flags & TLRPC . USER_FLAG_BOT ) != 0 )	if ( var . bot var )
if ( var != null && var != null )	if ( var != null && var . bot && var != null )
if ( ChatObject . isChannel ( var ) )	if ( ChatObject . isChannel ( var ) && ! var . megagroup && ! ( var instanceof TLRPC . TL_channelForbidden ) var )
if ( var && var . isEmpty ( ) )	if ( var && var . isEmpty ( var ) var )
var . setButtons ( var )	var . setButtons ( var , false )
int var = var . length ( )	int var = var . findFirstVisibleItemPosition ( var )
for ( int var = 0 ; var < var ; var ++ )	for ( int var = 0 ; var < var . size ( var ) ; var ++ )
var = 0	var = true
if ( var instanceof String )	if ( var instanceof String var )
for ( int var = 0 ; var < var . size ( ) ; var ++ )	for ( int var = 0 ; var < var . size ( var ) ; var ++ )
var . append ( LocaleController . formatPluralString ( "" , var . size ( ) - 1 ) , var . size ( ) - 1 )	var . append ( LocaleController . formatPluralString ( "" , var . size ( var ) - 1 ) , var . size ( var ) - 1 )
if ( var == - 1 || var == 0 )	if ( var == - 1 || var == 0 || var == 10 || var == 11 var )
var . showTopView ( var )	var . showTopView ( var , var )
var . clear ( )	var . clear ( var )
var = Integer . MIN_VALUE	var [ var ] . clear var
var = 0	minDate [ var ] = 0
var = true	endReached [ var ] = false
var = false	cacheEndReached [ var ] = false
var = false	forwardEndReached [ var ] = true
if ( var && var == 0 && var == 0 )	if ( forwardEndReached [ 0 ] && var == 0 && var == 0 var )
MessageObject var = var . get ( var )	MessageObject var = var [ var ] . get ( var )
var . scrollToPositionWithOffset ( var . size ( ) - var . indexOf ( var ) , - var . getPaddingTop ( ) - AndroidUtilities . dp ( 7 ) + var )	var . scrollToPositionWithOffset ( var . messagesStartRow + var . size ( var ) - var . indexOf ( var ) - 1 , - var . getPaddingTop ( var ) - AndroidUtilities . dp ( 7 ) + var )
var . clear ( )	clearChatData var
var . clear ( )	var . add ( var )
if ( var == null )	if ( var == null var )
var = Integer . MAX_VALUE	minMessageId [ var ] = Integer . MAX_VALUE
var = Integer . MIN_VALUE	maxDate [ var ] = Integer . MIN_VALUE
var = Integer . MIN_VALUE	maxMessageId [ var ] = Integer . MIN_VALUE
var = Integer . MAX_VALUE	maxMessageId [ var ] = Integer . MAX_VALUE
var = Integer . MIN_VALUE	minMessageId [ var ] = Integer . MIN_VALUE
if ( var . containsKey ( var . getId ( ) ) )	if ( var [ var ] . containsKey ( var . getId ( var ) ) var )
var . remove ( var . getId ( ) )	var [ var ] . remove ( var . getId ( var ) )
var . remove ( var . getId ( ) )	if ( var [ var ] . containsKey ( var . getId ( var ) ) var )
var . put ( var . getId ( ) , var )	var [ var ] . put ( var . getId ( var ) , var )
var . put ( var . getId ( ) , var )	var [ var ] . put ( var . getId ( var ) , var )
if ( actionBar . isActionModeShowed ( ) )	if ( actionBar . isActionModeShowed ( var ) )
if ( var . isEmpty ( ) )	if ( var [ 0 ] . isEmpty var && var [ 1 ] . isEmpty var var )
if ( var || var != null && ( ChatObject . isNotInChat ( var ) || ChatObject . isChannel ( var ) && ( var . flags & TLRPC . CHAT_FLAG_ADMIN ) == 0 && ( var . flags & TLRPC . CHAT_FLAG_USER_IS_EDITOR ) == 0 ) = false )	if ( var || var != null && ( ChatObject . isNotInChat ( var ) || ChatObject . isChannel ( var ) && ! var . creator && ! var . editor && ! var . megagroup ) = false )
if ( ! var . isEmpty ( ) )	if ( ! var [ 0 ] . isEmpty var || ! var [ 1 ] . isEmpty var )
if ( var == null || var == null || var != null || ( var . flags & TLRPC . USER_FLAG_BOT ) == 0 )	if ( var == null || var == null || var != null || ! var . bot )
if ( var == null || var . length ( ) == 0 || ChatObject . isChannel ( var ) )	if ( var == null || var . length ( var ) == 0 || ChatObject . isChannel ( var ) && ! var . megagroup var )
if ( ( var . flags & TLRPC . CHAT_FLAG_IS_BROADCAST ) == 0 )	if ( ! var . broadcast && ! var . megagroup && ! ( var instanceof TLRPC . TL_channelForbidden ) var )
if ( var . getVisibility ( ) != View . VISIBLE )	if ( var != null && var . getVisibility ( var ) != View . VISIBLE )
if ( var != null && var . participants_count != 0 )	if ( var != null && var . participants_count != 0 var )
if ( ( var . flags & TLRPC . CHAT_FLAG_IS_PUBLIC ) != 0 )	if ( ( var . flags & TLRPC . CHAT_FLAG_IS_PUBLIC ) != 0 var )
var . setText ( LocaleController . getString ( "" , R . string . ChannelPublic ) , R . string . ChannelPublic . toLowerCase )	var . setText ( LocaleController . getString ( "" , R . string . ChannelPublic ) , R . string . ChannelPublic . toLowerCase var )
if ( var . getVisibility ( ) != View . GONE )	if ( var != null && var . getVisibility ( var ) != View . GONE )
if ( ( var . flags & TLRPC . USER_FLAG_BOT ) != 0 )	if ( var . bot )
if ( var == var )	if ( var == classGuid )
var = var == 0 && var == 0	forwardEndReached [ var ] = var == 0 && var == 0
if ( ! var )	if ( ! forwardEndReached [ var ] )
var . clear ( )	var [ var ] . clear var
if ( var == null )	if ( var == null var )
var = Integer . MAX_VALUE	minMessageId [ var ] = Integer . MAX_VALUE
var = Integer . MIN_VALUE	maxDate [ var ] = Integer . MIN_VALUE
var = Integer . MIN_VALUE	maxMessageId [ var ] = Integer . MIN_VALUE
var = Integer . MAX_VALUE	maxMessageId [ var ] = Integer . MAX_VALUE
var = Integer . MIN_VALUE	minMessageId [ var ] = Integer . MIN_VALUE
var = 0	minDate [ var ] = 0
for ( int var = 0 ; var < var . size ( ) ; var ++ )	for ( int var = 0 ; var < var . size ( var ) ; var ++ )
if ( var . containsKey ( var . getId ( ) ) )	if ( var [ 0 ] . containsKey ( var . getId ( var ) ) )
if ( var == 0 || var . messageOwner . date < var )	if ( minDate [ 0 ] == 0 || var . messageOwner . date < minDate [ 0 ] )
var = var . messageOwner . date	minDate [ 0 ] = var . messageOwner . date
var . put ( var . getId ( ) , var )	var [ 0 ] . put ( var . getId ( var ) , var )
if ( var . getId ( ) == var = true )	if ( var . getId ( var ) == var )
var = true	forwardEndReached [ var ] = true
if ( var . size ( ) != var && ! var )	if ( var . size ( var ) != var && ! var )
if ( var = true )	if ( var var )
if ( var != null || var = true )	if ( var != null || var )
var = true	endReached [ var ] = true
var = true	cacheEndReached [ var ] = true
var = true	endReached [ var ] = true
int var = var . findLastVisibleItemPosition ( )	int var = var . findLastVisibleItemPosition ( var )
if ( var && var . size ( ) > 0 )	if ( var && var . size ( var ) > 0 )
if ( var != 0 )	if ( var != 0 var )
if ( var . isEmpty ( ) && var == null && var != null && ( var . flags & TLRPC . USER_FLAG_BOT ) != 0 && var == null )	if ( var . isEmpty ( var ) && var == null && var != null && var . bot && var == null )
if ( var == 0 && var != null && ! var )	if ( var == 0 && var != null && ! endReached [ 0 ] var )
var . setEmptyView ( null )	if ( var != null )
if ( ( var & MessagesController . UPDATE_MASK_NAME ) != 0 || ( var & MessagesController . UPDATE_MASK_CHAT_NAME ) != 0 )	if ( ( var & MessagesController . UPDATE_MASK_NAME ) != 0 || ( var & MessagesController . UPDATE_MASK_CHAT_NAME ) != 0 var )
if ( var != updateOnlineCount = true )	if ( var != updateOnlineCount var = true )
if ( ! var )	if ( ! forwardEndReached [ 0 ] var )
if ( var . containsKey ( var . getId ( ) ) )	if ( var [ var ] . containsKey ( var . getId ( var ) ) )
var = Math . max ( var . getId ( ) , var )	var = Math . max ( var . getId ( var ) , var )
if ( var . containsKey ( var . getId ( ) ) )	if ( var [ 0 ] . containsKey ( var . getId ( var ) ) )
if ( var == 0 || var . messageOwner . date < var )	if ( minDate [ var ] == 0 || var . messageOwner . date < minDate [ var ] )
var = var . messageOwner . date	minDate [ var ] = var . messageOwner . date
var . put ( var . getId ( ) , var )	var [ var ] . put ( var . getId ( var ) , var )
if ( var ++ )	if ( endReached [ 0 ] ++ )
if ( var == var || var )	if ( var >= var || var var )
var = var	var = maxDate [ 0 ]
var = var	var = minMessageId [ 0 ]
if ( var == 0 || var != var . var )	if ( var == var . var = 0 )
if ( ! var && ! var )	if ( ! endReached [ 0 ] && ! var var )
if ( var == null )	if ( var == null var )
var = Integer . MIN_VALUE	maxMessageId [ 0 ] = maxMessageId [ 1 ] = Integer . MIN_VALUE
if ( var == null && var != null && ( var . flags & TLRPC . USER_FLAG_BOT ) != 0 && var == null )	if ( var == null && var != null && var . bot && var == null )
MessageObject var = var . get ( var )	MessageObject var = var [ 0 ] . get ( var )
if ( ! var . equals ( var ) && var . containsKey ( var ) )	if ( ! var . equals ( var ) && var [ 0 ] . containsKey ( var ) )
MessageObject var = var . remove ( var )	MessageObject var = var [ 0 ] . get ( var )
var = var . media != null && var . messageOwner . media != null && ! var . media . getClass ( ) . equals ( var . messageOwner . media . getClass ( ) )	var = var . media != null && var . messageOwner . media != null && ! var . media . getClass ( var ) . equals ( var . messageOwner . media . getClass ( var ) )
var . remove ( var )	var [ 0 ] . remove ( var )
var . put ( var , var )	var [ 0 ] . put ( var , var )
MessageObject var = var . get ( var )	MessageObject var = var [ 0 ] . remove ( var )
MessageObject var = var . get ( var )	MessageObject var = var [ 0 ] . get ( var )
TLRPC . TL_chatParticipant var = var . participants . participants . get ( var )	TLRPC . ChatParticipant var = var . participants . participants . get ( var )
if ( var != null && ( var . flags & TLRPC . USER_FLAG_BOT ) != 0 )	if ( var != null && var . bot )
if ( var . getMessageObject ( ) != null && var . getMessageObject ( ) . getId == var )	if ( var . getMessageObject ( var ) != null && var . getMessageObject ( var ) . getId var == var )
var . clear ( )	var [ var ] . clear var
if ( var == null )	if ( var == null var )
var = Integer . MAX_VALUE	minMessageId [ var ] = Integer . MAX_VALUE
var = Integer . MIN_VALUE	maxDate [ var ] = Integer . MIN_VALUE
var = Integer . MIN_VALUE	maxMessageId [ var ] = Integer . MIN_VALUE
var = Integer . MAX_VALUE	maxMessageId [ var ] = Integer . MAX_VALUE
var = Integer . MIN_VALUE	minMessageId [ var ] = Integer . MIN_VALUE
var = 0	minDate [ var ] = 0
var . clear ( )	var [ var ] . clear var
var . clear ( )	var [ var ] . clear var
if ( var == null && var != null && ( var . flags & TLRPC . USER_FLAG_BOT ) != 0 && var == null )	if ( var == null && var != null && var . bot && var == null )
var = true	endReached [ var ] = false
var = false	cacheEndReached [ var ] = false
var = false	forwardEndReached [ var ] = true
MessageObject var = var . get ( var . getId ( ) )	MessageObject var = var [ var ] . get ( var . getId ( var ) )
MessageObject var = var . get ( var )	MessageObject var = var [ 0 ] . get ( var )
if ( var . getMessageObject ( ) != null )	if ( var . getMessageObject ( var ) != null )
MessageObject var = var . get ( var . getId ( ) )	MessageObject var = var [ 0 ] . get ( var . getId ( var ) )
if ( var == ( long ) var [ 0 ] )	if ( var == NotificationCenter . replaceMessagesObjects )
MessageObject var = var . get ( var . getId ( ) )	MessageObject var = var [ 0 ] . get ( var . getId ( var ) )
var . put ( var . getId ( ) , var )	var [ var ] . put ( var . getId ( var ) , var )
if ( ChatObject . isChannel ( var )  )	if ( ChatObject . isChannel ( var ) var )
var . messageOwner . media = new TLRPC . TL_messageMediaWebPage ( )	var . messageOwner . media = new TLRPC . TL_messageMediaWebPage ( var )
MessageObject var = var . get ( ( int ) var )	MessageObject var = var [ 0 ] . get ( ( int ) var )
var . setContentIsRead ( )	var . setContentIsRead ( var )
if ( var )	if ( var var )
if ( var != null )	if ( var != null && ! var var )
if ( var . messageOwner . reply_markup instanceof TLRPC . TL_replyKeyboardForceReply )	if ( var . messageOwner . reply_markup instanceof TLRPC . TL_replyKeyboardForceReply var )
if ( var . getInt ( "" + var , 0 ) != var . getId ( ) && ( var == null || var . getFieldText ( ) == null ) )	if ( var . getInt ( "" + var , 0 ) != var . getId ( var ) && ( var == null || var . getFieldText ( var ) == null ) )
MessageObject var = var . get ( var )	MessageObject var = var [ 0 ] . get ( var )
if ( ChatObject . isChannel ( var ) )	if ( ChatObject . isChannel ( var ) && ! var . megagroup && ! ( var instanceof TLRPC . TL_channelForbidden ) var )
if ( ( var . flags & TLRPC . USER_FLAG_BOT ) != 0 )	if ( var . bot var )
if ( var != null )	if ( var != null && var . bot )
if ( var != null )	if ( var != null && var . bot var )
if ( var . messageOwner . action . user_id == UserConfig . getClientUserId ( ) )	if ( var . messageOwner . action . user_id == UserConfig . getClientUserId ( var ) || var . messageOwner . action . users . contains ( UserConfig . getClientUserId ( var ) ) )
if ( var != null && ContactsController . getInstance ( ) . contactsDict . get ( var . id ) != null = null )	if ( var != null && ContactsController . getInstance ( var ) . contactsDict . get ( var . id ) != null = null )
if ( ( var . flags & TLRPC . USER_FLAG_BOT ) == 0 && var . id / 1000 != 333 && var . id / 1000 != 777 && ! UserObject . isDeleted ( var ) && ! var && ! ContactsController . getInstance ( ) . isLoadingContacts && ( var . phone == null || var . phone . length ( ) == 0 || ContactsController . getInstance ( ) . contactsDict . get ( var . id ) == null ) )	if ( ! var . bot && var . id / 1000 != 333 && var . id / 1000 != 777 && ! UserObject . isDeleted ( var ) && ! var && ! ContactsController . getInstance ( var ) . isLoadingContacts var && ( var . phone == null || var . phone . length ( var ) == 0 || ContactsController . getInstance ( var ) . contactsDict . get ( var . id ) == null ) )
if ( var . getVisibility ( ) != View . VISIBLE )	if ( var . getTag ( var ) != null )
if ( var . getVisibility ( ) != View . GONE )	if ( var . getVisibility ( var ) != View . GONE )
if ( var != null && ! ( var instanceof TLRPC . TL_encryptedChat ) || var . id / 1000 == 333 || var . id / 1000 == 777 || UserObject . isDeleted ( var ) || ContactsController . getInstance ( ) . isLoadingContacts || ( var . phone != null && var . phone . length ( ) != 0 && ContactsController . getInstance ( ) . contactsDict . get ( var . id ) != null && ( ContactsController . getInstance ( ) . contactsDict . size ( ) != 0 || ! ContactsController . getInstance ( ) . isLoadingContacts ) ) )	if ( var != null && ! ( var instanceof TLRPC . TL_encryptedChat ) || var . id / 1000 == 333 || var . id / 1000 == 777 || UserObject . isDeleted ( var ) || ContactsController . getInstance ( var ) . isLoadingContacts var || ( var . phone != null && var . phone . length ( var ) != 0 && ContactsController . getInstance ( var ) . contactsDict . get ( var . id ) != null && ( ContactsController . getInstance ( var ) . contactsDict . size ( var ) != 0 || ! ContactsController . getInstance ( var ) . isLoadingContacts var ) ) var )
var = Math . max ( 0 , ( var . getHeight ( ) - var . getApproximateHeight ( ) ) / 2 )	var = Math . max ( 0 , ( var . getHeight ( var ) - var . getApproximateHeight ( var ) ) / 2 )
MessagesController . getInstance ( ) . markDialogAsRead ( var , var . get ( 0 ) . getId , var , 0 , var , true , false )	MessagesController . getInstance ( var ) . markDialogAsRead ( var , var . get ( 0 ) . getId var , var , var , true , false )
var . edit ( ) . remove ( "" + var ) . commit	var . edit ( var ) . remove ( "" + var ) . commit var
ArrayList < Long > var = new ArrayList	ArrayList < Long > var = new ArrayList var ( var )
FrameLayout . LayoutParams var = ( FrameLayout . LayoutParams ) var . getLayoutParams ( )	FrameLayout . LayoutParams var = ( FrameLayout . LayoutParams ) var . getLayoutParams ( var )
if ( var != null )	if ( var != null var )
var . clear ( )	var [ var ] . clear var
var . clear ( )	var [ var ] . clear var
if ( var || var != null && ( ChatObject . isNotInChat ( var ) || ChatObject . isChannel ( var ) && ( var . flags & TLRPC . CHAT_FLAG_ADMIN ) == 0 && ( var . flags & TLRPC . CHAT_FLAG_USER_IS_EDITOR ) == 0 ) = false )	if ( var == 1 && var . getDialogId ( var ) == var || var . getId ( var ) < 0 || var || var != null && ( ChatObject . isNotInChat ( var ) || ChatObject . isChannel ( var ) && ! var . creator && ! var . editor && ! var . megagroup ) = false )
AlertDialog . Builder var = new AlertDialog . Builder ( getParentActivity )	AlertDialog . Builder var = new AlertDialog . Builder ( getParentActivity var )
if ( var != 0 && ( var != null || ! var . isEmpty ( ) ) )	if ( var != 0 && ( var != null || ! var [ 0 ] . isEmpty var || ! var [ 1 ] . isEmpty var ) )
if ( var != null )	if ( var != null var )
MessageObject var = var . get ( var )	MessageObject var = var [ var ] . get ( var )
var . clear ( )	var [ var ] . clear var
var . clear ( )	var [ var ] . clear var
showReplyPanel ( true , null , var , null , false , AndroidUtilities . isTablet ( ) )	showReplyPanel ( true , null , var , null , false , AndroidUtilities . isTablet ( var ) )
var . clear ( )	var [ var ] . clear var
var . clear ( )	var [ var ] . clear var
if ( actionBar . isActionModeShowed ( ) )	if ( actionBar . isActionModeShowed ( var ) var )
MessagesSearchQuery . searchMessagesInChat ( var , var , classGuid , 0 )	MessagesSearchQuery . searchMessagesInChat ( var , var , var , classGuid , 0 )
var = var != null && ( var . flags & TLRPC . USER_FLAG_BOT ) != 0	var = var != null && var . bot
if ( var != null && ( var . flags & TLRPC . USER_FLAG_BOT ) != 0 )	if ( var != null && var . bot var )
var . setCommand ( var , var , var )	var . setCommand ( var , var , var , var != null && var . megagroup )
PhotoViewer . getInstance ( ) . openPhoto ( var , ChatActivity . this )	PhotoViewer . getInstance ( var ) . openPhoto ( var , 0 , 0 , ChatActivity . this )
if ( var == null || var . length ( ) == 0 = null )	if ( var == null || var . length ( var ) == 0 = null )
getParentActivity . startActivityForResult ( var , 500 )	getParentActivity var . startActivityForResult ( var , 500 )
if ( getParentActivity == null || var . messageOwner . media . phone_number == null || var . messageOwner . media . phone_number . length ( ) == 0 )	if ( getParentActivity var == null || var . messageOwner . media . phone_number == null || var . messageOwner . media . phone_number . length ( var ) == 0 )
AlertDialog . Builder var = new AlertDialog . Builder ( getParentActivity )	AlertDialog . Builder var = new AlertDialog . Builder ( getParentActivity var )
PhotoViewer . getInstance ( ) . setParentActivity ( getParentActivity )	PhotoViewer . getInstance ( var ) . setParentActivity ( getParentActivity var )
var = ( var . flags & 1 ) == 0	var = ! var . resize
if ( ! var )	if ( ! var || var )
if ( ! var )	if ( ! var || var )
var = ChatObject . isChannel ( var ) && ( ( var . flags & TLRPC . CHAT_FLAG_ADMIN ) != 0 || ( var . flags & TLRPC . CHAT_FLAG_USER_IS_EDITOR ) != 0 )	var = ChatObject . isChannel ( var ) && ( var . creator || var . editor ) && ! var . megagroup
var = var && ( var . flags & TLRPC . CHAT_FLAG_IS_BROADCAST ) == 0	var = var && ! var . broadcast
String var = var . trim ( )	var = var . trim ( )
if ( var != 1 && var != null && ( var . flags & TLRPC . USER_FLAG_BOT ) != 0 && ! var . contains ( "" ) )	if ( ( var != 1 || var ) && var != null && var . bot && ! var . contains ( "" ) )
if ( var != null var . messageOwner . reply_markup . flags & 2 ) != 0 )	if ( var != null . messageOwner . reply_markup . single_use )
if ( ( var . messageOwner . reply_markup . flags & 2 ) != 0 )	if ( var . messageOwner . reply_markup . single_use )
if ( var != var && ( var . flags & 2 ) != 0 )	if ( var != var && var . single_use )
if ( ( var . set . flags & 2 ) != 0 || var . documents == null || var . documents . isEmpty ( var ) )	if ( var . set . disabled || var . documents == null || var . documents . isEmpty ( var ) )
var . setDuration ( 300 )	var . setDuration ( 200 )
return ( var . bottom - var . top ) - var	int var = ( var . bottom - var . var )
var . setBackgroundColor ( 0xffcdcdcd )	var . setBackgroundResource ( R . drawable . header_shadow )
addView ( var , LayoutHelper . createFrame ( LayoutHelper . MATCH_PARENT , 1 , Gravity . TOP | Gravity . LEFT , 0 , 40 , 0 , 0 ) . MATCH_PARENT , 1 , Gravity . TOP | Gravity . LEFT , 0 , 40 , 0 , 0 )	addView ( var , LayoutHelper . createFrame ( LayoutHelper . MATCH_PARENT , 3 , Gravity . TOP | Gravity . LEFT , 0 , 40 , 0 , 0 ) . MATCH_PARENT , 3 , Gravity . TOP | Gravity . LEFT , 0 , 40 , 0 , 0 )
var = new SearchAdapter ( var , var , var , false , false )	var = new SearchAdapter ( var , var , var , false , false , var )
if ( ( var . flags & TLRPC . USER_FLAG_BOT ) != 0 && ( var . flags & TLRPC . USER_FLAG_BOT_CANT_JOIN_GROUP ) != 0 )	if ( var . bot && var . bot_nochats )
if ( ( var . flags & TLRPC . USER_FLAG_BOT ) == 0 && var )	if ( ! var . bot && var )
MessagesController . getInstance ( ) . loadDialogs ( 0 , 0 , 0 , 100 , true )	MessagesController . getInstance ( ) . loadDialogs ( 0 , 100 , true )
if ( var != null )	if ( var != null && var . getAdapter ( ) != var )
if ( var == null || ( var . flags & TLRPC . CHAT_FLAG_ADMIN ) == 0 )	if ( var == null || ! var . creator var )
MessagesController . getInstance ( ) . deleteDialog ( var , 0 , false )	MessagesController . getInstance ( ) . deleteDialog ( var , false )
MessagesController . getInstance ( ) . deleteDialog ( var , 0 , true )	MessagesController . getInstance ( ) . deleteDialog ( var , false )
if ( var . findLastVisibleItemPosition ( ) == getDialogsArray . size )	if ( var . findLastVisibleItemPosition ( ) >= getDialogsArray . size - 10 )
MessagesController . getInstance ( ) . loadDialogs ( MessagesController . getInstance ( ) . dialogs . size ( ) , MessagesController . getInstance ( ) . currentDialogsCount , - 1 , 100 , true )	MessagesController . getInstance ( ) . loadDialogs ( - 1 , 100 , ! MessagesController . getInstance ( ) . dialogsEndReached )
var = new SearchAdapter ( var , null , false , false , false )	var = new SearchAdapter ( var , null , false , false , false , false )
var = new UserCell ( var , 1 )	var = new UserCell ( var , 1 , 0 )
if ( ChatObject . isChannel ( var ) )	if ( ChatObject . isChannel ( var ) && ! var . megagroup )
var = new UserCell ( var , 1 )	var = new UserCell ( var , 1 , 0 )
if ( var == null || ( var . flags & TLRPC . USER_FLAG_BOT ) != 0 && ( var . flags & TLRPC . USER_FLAG_BOT_CANT_JOIN_GROUP ) != 0 )	if ( var == null || var . bot && var . bot_nochats )
if ( ( var . flags & 1 ) != 0 || ChatObject . isChannel ( var . chat ) )	if ( ! var . megagroup && var . channel || ChatObject . isChannel ( var . chat ) && ! var . chat . megagroup )
ScrollView . LayoutParams var = ( ScrollView . LayoutParams ) var . getLayoutParams ( )	var . addView ( var , LayoutHelper . createScroll ( LayoutHelper . MATCH_PARENT , LayoutHelper . WRAP_CONTENT , Gravity . TOP | Gravity . LEFT ) . MATCH_PARENT , LayoutHelper . WRAP_CONTENT , Gravity . TOP | Gravity . LEFT )
public PhoneView ( Context var )	public PhoneView ( final Context var )
LayoutParams var = ( LayoutParams ) var . getLayoutParams ( )	addView ( var , LayoutHelper . createLinear ( LayoutHelper . MATCH_PARENT , 1 , 4 , - 17.5f , 4 , 0 ) . MATCH_PARENT , 1 , 4 , - 17.5f , 4 , 0 )
var . width = LayoutHelper . MATCH_PARENT	addView ( var , LayoutHelper . createLinear ( LayoutHelper . MATCH_PARENT , 36 , 0 , 0 , 0 , 14 ) . MATCH_PARENT , 36 , 0 , 0 , 0 , 14 )
var . setLayoutParams ( var )	var . addView ( var , LayoutHelper . createLinear ( 55 , 36 , - 9 , 0 , 16 , 0 ) , 36 , - 9 , 0 , 16 , 0 )
var . height = 1	var = 1
var . width = LayoutHelper . MATCH_PARENT	addView ( var , LayoutHelper . createLinear ( LayoutHelper . MATCH_PARENT , 1 , 4 , - 17.5f , 4 , 0 ) . MATCH_PARENT , 1 , 4 , - 17.5f , 4 , 0 )
var . height = LayoutHelper . WRAP_CONTENT	var . addView ( var , LayoutHelper . createLinear ( LayoutHelper . WRAP_CONTENT , LayoutHelper . WRAP_CONTENT ) . WRAP_CONTENT , LayoutHelper . WRAP_CONTENT )
var . width = LayoutHelper . WRAP_CONTENT	var . addView ( var , LayoutHelper . createLinear ( LayoutHelper . WRAP_CONTENT , LayoutHelper . WRAP_CONTENT ) . WRAP_CONTENT , LayoutHelper . WRAP_CONTENT )
var . setLayoutParams ( var )	int var = var . getSelectionStart ( )
var [ 0 ] = new InputFilter . LengthFilter ( 4 )	var [ 0 ] = new InputFilter . LengthFilter ( 5 )
var = ( LayoutParams ) var . getLayoutParams ( )	String var = var . getText ( ) . toString
var . setLayoutParams ( var )	StringBuilder var = new StringBuilder ( var . length ( ) )
var = new EditText ( var )	var = new HintEditText ( var )
var = ( LayoutParams ) var . getLayoutParams ( )	for ( int var = 0 ; var < var . length ( ) ; var ++ )
var . width = LayoutHelper . MATCH_PARENT	var . addView ( var , LayoutHelper . createFrame ( LayoutHelper . MATCH_PARENT , 36 ) . MATCH_PARENT , 36 )
var . setLayoutParams ( var )	String var = var . getHintText ( )
if ( ! var . contains ( var ) )	if ( var . charAt ( var ) == ' ' )
var = var . substring ( var , var + 1 )	String var = var . substring ( var , var + 1 )
var = var . toString ( )	var . insert ( var , ' ' )
var . setText ( "" )	var . setText ( var )
var . bottomMargin = AndroidUtilities . dp ( 10 )	var . onTextChange ( )
if ( ! var . equals ( var ) )	if ( var . length ( ) != 0 )
var = PhoneFormat . getInstance ( ) . format ( var . getText ( ) . toString ) . trim	String var = var . getText ( ) . toString
var . setText ( var )	AndroidUtilities . showKeyboard ( var )
var . setText ( var . substring ( var ) . trim )	var . requestFocus ( )
var . setLayoutParams ( var )	if ( var . length ( ) == 5 )
LayoutParams var = ( LayoutParams ) var . getLayoutParams ( )	addView ( var , LayoutHelper . createLinear ( LayoutHelper . MATCH_PARENT , 36 , Gravity . CENTER_HORIZONTAL , 0 , 20 , 0 , 0 ) . MATCH_PARENT , 36 , Gravity . CENTER_HORIZONTAL , 0 , 20 , 0 , 0 )
LayoutParams var = ( LayoutParams ) var . getLayoutParams ( )	addView ( var , LayoutHelper . createLinear ( LayoutHelper . MATCH_PARENT , 36 , Gravity . CENTER_HORIZONTAL , 0 , 20 , 0 , 0 ) . MATCH_PARENT , 36 , Gravity . CENTER_HORIZONTAL , 0 , 20 , 0 , 0 )
var . width = LayoutHelper . MATCH_PARENT	addView ( var , LayoutHelper . createLinear ( LayoutHelper . MATCH_PARENT , LayoutHelper . MATCH_PARENT ) . MATCH_PARENT , LayoutHelper . MATCH_PARENT )
var . height = AndroidUtilities . dp ( 36 )	addView ( var , LayoutHelper . createLinear ( LayoutHelper . MATCH_PARENT , 36 , 0 , 10 , 0 , 0 ) . MATCH_PARENT , 36 , 0 , 10 , 0 , 0 )
var . topMargin = AndroidUtilities . dp ( 26 )	addView ( var , LayoutHelper . createLinear ( LayoutHelper . MATCH_PARENT , 36 , 0 , 26 , 0 , 0 ) . MATCH_PARENT , 36 , 0 , 26 , 0 , 0 )
var . width = LayoutHelper . MATCH_PARENT	addView ( var , LayoutHelper . createLinear ( LayoutHelper . MATCH_PARENT , LayoutHelper . MATCH_PARENT ) . MATCH_PARENT , LayoutHelper . MATCH_PARENT )
var . height = AndroidUtilities . dp ( 36 )	addView ( var , LayoutHelper . createLinear ( LayoutHelper . MATCH_PARENT , 36 , 0 , 26 , 0 , 0 ) . MATCH_PARENT , 36 , 0 , 26 , 0 , 0 )
var . topMargin = AndroidUtilities . dp ( 10 )	addView ( var , LayoutHelper . createLinear ( LayoutHelper . MATCH_PARENT , 36 , 0 , 10 , 0 , 0 ) . MATCH_PARENT , 36 , 0 , 10 , 0 , 0 )
var . width = LayoutHelper . MATCH_PARENT	addView ( var , LayoutHelper . createLinear ( LayoutHelper . MATCH_PARENT , 36 , 0 , 10 , 0 , 0 ) . MATCH_PARENT , 36 , 0 , 10 , 0 , 0 )
var . height = LayoutHelper . MATCH_PARENT	addView ( var , LayoutHelper . createLinear ( LayoutHelper . MATCH_PARENT , 36 , 0 , 26 , 0 , 0 ) . MATCH_PARENT , 36 , 0 , 26 , 0 , 0 )
if ( var . containsKey ( var . getId ( ) ) )	if ( var [ var ] . containsKey ( var . getId ( var ) ) )
var . put ( var . getId ( ) , var )	var [ var ] . put ( var . getId ( var ) , var )
if ( ! var )	if ( ! var var )
if ( var . getId ( ) > 0 )	if ( var . getId ( var ) > 0 )
MessageObject var = var . get ( var )	MessageObject var = var [ var ] . get ( var )
var . remove ( var . getId ( ) )	var [ var ] . remove ( var . getId ( var ) )
if ( var . isEmpty ( ) )	if ( var . isEmpty ( var ) )
var . put ( var , var )	var [ 0 ] . put ( var , var )
var . clear ( var )	var [ var ] . clear var
MessageObject var = var . get ( var . get ( 0 ) )	MessageObject var = var [ var ] . get ( var . get ( 0 ) )
var . clear ( var )	var [ var ] . clear var
var . clear ( var )	var [ var ] . clear var
var . clear ( var )	var [ var ] . clear var
if ( var != 0 && var + var > var - 2 && ! sharedMediaData [ var ] . loading && ! sharedMediaData [ var ] . endReached )	if ( var != 0 && var + var > var - 2 && ! sharedMediaData [ var ] . loading )
if ( var == var && var == classGuid )	if ( var == classGuid )
sharedMediaData [ var ] . endReached = ( Boolean ) var [ 5 ]	sharedMediaData [ var ] . endReached [ var ] = ( Boolean ) var [ 5 ]
if ( var == 0 || var != var . var )	if ( var == var . var = 0 )
if ( var . deleteMessage ( var ) = true )	if ( var . deleteMessage ( var , var ) = true )
if ( ! sharedMediaData [ var ] . loading && ! sharedMediaData [ var ] . endReached && sharedMediaData [ var ] . messages . isEmpty ( var ) )	if ( ! sharedMediaData [ var ] . loading && ! sharedMediaData [ var ] . endReached [ 0 ] && sharedMediaData [ var ] . messages . isEmpty ( var ) )
if ( ! sharedMediaData [ var ] . loading && ! sharedMediaData [ var ] . endReached && sharedMediaData [ var ] . messages . isEmpty ( var ) )	if ( ! sharedMediaData [ var ] . loading && ! sharedMediaData [ var ] . endReached [ 0 ] && sharedMediaData [ var ] . messages . isEmpty ( var ) )
if ( var . containsKey ( var . getId ( var ) ) var )	if ( var [ var ] . containsKey ( var . getId ( var ) ) var )
var . put ( var . getId ( var ) , var )	var [ var ] . put ( var . getId ( var ) , var )
if ( var . isEmpty ( var ) var )	if ( var [ 0 ] . isEmpty var && var [ 1 ] . isEmpty var var )
( ( GreySectionCell ) var ) . setText ( LocaleController . formatterMonthYear . format ( ( long ) var . messageOwner . date * 1000 ) long ) var . messageOwner . date * 1000 . toUpperCase var )	( ( SharedMediaSectionCell ) var ) . setText ( LocaleController . getInstance ( var ) . formatterMonthYear . format ( ( long ) var . messageOwner . date * 1000 ) long ) var . messageOwner . date * 1000 . toUpperCase var )
( ( GreySectionCell ) var ) . setText ( LocaleController . formatterMonthYear . format ( ( long ) var . messageOwner . date * 1000 ) long ) var . messageOwner . date * 1000 . toUpperCase var )	( ( SharedMediaSectionCell ) var ) . setText ( LocaleController . getInstance ( var ) . formatterMonthYear . format ( ( long ) var . messageOwner . date * 1000 ) long ) var . messageOwner . date * 1000 . toUpperCase var )
( ( GreySectionCell ) var ) . setText ( LocaleController . formatterMonthYear . format ( ( long ) var . messageOwner . date * 1000 ) long ) var . messageOwner . date * 1000 . toUpperCase var )	( ( GreySectionCell ) var ) . setText ( LocaleController . getInstance ( var ) . formatterMonthYear . format ( ( long ) var . messageOwner . date * 1000 ) long ) var . messageOwner . date * 1000 . toUpperCase var )
( ( GreySectionCell ) var ) . setText ( LocaleController . formatterMonthYear . format ( ( long ) var . messageOwner . date * 1000 ) long ) var . messageOwner . date * 1000 . toUpperCase var )	( ( GreySectionCell ) var ) . setText ( LocaleController . getInstance ( var ) . formatterMonthYear . format ( ( long ) var . messageOwner . date * 1000 ) long ) var . messageOwner . date * 1000 . toUpperCase var )
( ( SharedMediaSectionCell ) var ) . setText ( LocaleController . formatterMonthYear . format ( ( long ) var . messageOwner . date * 1000 ) long ) var . messageOwner . date * 1000 . toUpperCase var )	( ( GreySectionCell ) var ) . setText ( LocaleController . getInstance ( var ) . formatterMonthYear . format ( ( long ) var . messageOwner . date * 1000 ) long ) var . messageOwner . date * 1000 . toUpperCase var )
( ( SharedMediaSectionCell ) var ) . setText ( LocaleController . formatterMonthYear . format ( ( long ) var . messageOwner . date * 1000 ) long ) var . messageOwner . date * 1000 . toUpperCase var )	( ( GreySectionCell ) var ) . setText ( LocaleController . getInstance ( var ) . formatterMonthYear . format ( ( long ) var . messageOwner . date * 1000 ) long ) var . messageOwner . date * 1000 . toUpperCase var )
queryServerSearch ( var , var . getId ( var ) )	queryServerSearch ( var , var . getId ( var ) , var . getDialogId ( var ) )
if ( var == 3 )	if ( var == 3 || var == 4 )
if ( var == 1 || var == 4 )	if ( var == 1 )
if ( var == var )	if ( var == var || var == var )
if ( ( int ) var != 0 && ( Boolean ) var [ 2 ] )	if ( ( Boolean ) var [ 2 ] )
var . setTitle ( LocaleController . formatString ( "" , R . string . Of , ( var - var . size ( var ) ) + var + 1 , var ) , R . string . Of , ( var - var . size ( var ) ) + var + 1 , var )	var . setTitle ( LocaleController . formatString ( "" , R . string . Of , ( var + var - var . size ( var ) ) + var + 1 , var + var ) , R . string . Of , ( var + var - var . size ( var ) ) + var + 1 , var + var )
if ( var == var && var == var )	if ( ( var == var || var == var ) && var == var )
var = ( Boolean ) var [ 5 ]	endReached [ var ] = ( Boolean ) var [ 5 ]
if ( var . isEmpty ( var ) )	if ( var . isEmpty ( var ) && ( var != 0 || var == 0 ) )
if ( ! var . containsKey ( var . getId ( var ) ) )	if ( ! var [ var ] . containsKey ( var . getId ( var ) ) )
var . put ( var . getId ( var ) , var )	var [ var ] . put ( var . getId ( var ) , var )
if ( var == 0 )	if ( var == 0 && ( var != 0 || var == 0 ) )
var . clear ( var )	var [ var ] . clear var
var . clear ( var )	var [ var ] . clear var
if ( ! var || ! var . isEmpty ( var ) && var != 0 )	if ( ! endReached [ var ] )
if ( ! var . containsKey ( var . getId ( var ) ) )	if ( ! var [ var ] . containsKey ( var . getId ( var ) ) )
var . put ( var . getId ( var ) , var )	var [ var ] . put ( var . getId ( var ) , var )
var = false	endReached [ 0 ] = false
var . clear ( var )	var [ var ] . clear var
var . clear ( var )	var [ var ] . clear var
var . put ( var . getId ( var ) , var )	var [ 0 ] . put ( var . getId ( var ) , var )
if ( var . messageOwner . dialog_id != 0 var )	for ( int var = 0 ; var < var . size ( var ) ; var ++ )
var = var . messageOwner . dialog_id	for ( int var = 0 ; var < var . size ( var ) ; var ++ )
closePhoto ( false , false )	SharedMediaQuery . getMediaCount ( var , SharedMediaQuery . MEDIA_PHOTOVIDEO , var , false )
var = var . getDialogId ( var )	MessageObject var = var . get ( var )
String var = LocaleController . formatString ( "" , R . string . formatDateAtTime , LocaleController . formatterYear . format ( new Date ( var ) ) Date ( var ) , LocaleController . formatterDay . format ( new Date ( var ) ) Date ( var ) )	String var = LocaleController . formatString ( "" , R . string . formatDateAtTime , LocaleController . getInstance ( var ) . formatterYear . format ( new Date ( var ) ) Date ( var ) , LocaleController . getInstance ( var ) . formatterDay . format ( new Date ( var ) ) Date ( var ) )
openPhoto ( var , null , null , null , 0 , var , null )	openPhoto ( var , null , null , null , 0 , var , null , var , var )
openPhoto ( null , var , null , null , 0 , var , null )	openPhoto ( null , var , null , null , 0 , var , null , 0 , 0 )
openPhoto ( var . get ( var ) , null , var , null , var , var , null )	openPhoto ( var . get ( var ) , null , var , null , var , var , null , var , var )
openPhoto ( null , null , null , var , var , var , var )	openPhoto ( null , null , null , var , var , var , var , 0 , 0 )
int var = coords2 [ 1 ] - AndroidUtilities . statusBarHeight - ( var . viewY + var . top )	int var = coords2 [ 1 ] - AndroidUtilities . statusBarHeight - ( var . viewY + var . top ) + var . clipTopAddition
int var = coords2 [ 1 ] - AndroidUtilities . statusBarHeight - ( var . viewY + var . top )	int var = coords2 [ 1 ] - AndroidUtilities . statusBarHeight - ( var . viewY + var . top ) + var . clipTopAddition
MessagesController . getInstance ( ) . markDialogAsRead ( var . getDialogId ( ) , var . getId ( ) , Math . max ( 0 , var . getId ( ) ) , var . getId ( ) , 0 , var . messageOwner . date , true , true )	MessagesController . getInstance ( ) . markDialogAsRead ( var . getDialogId ( ) , var . getId ( ) , Math . max ( 0 , var . getId ( ) ) , var . getId ( ) , var . messageOwner . date , true , true )
if ( ( var . flags & TLRPC . USER_FLAG_BOT ) != 0 )	if ( var . bot )
if ( ( var . flags & TLRPC . USER_FLAG_BOT ) == 0 )	if ( ! var . bot var )
if ( ! var )	if ( ! var var )
MessagesController . getInstance ( ) . blockUser ( var )	MessagesController . getInstance ( var ) . blockUser ( var )
var . putString ( "" , LocaleController . getString ( "" , R . string . SendMessagesTo ) , R . string . SendMessagesTo )	var . putString ( "" , LocaleController . getString ( "" , R . string . SendContactTo ) , R . string . SendContactTo )
var . putString ( "" , LocaleController . getString ( "" , R . string . SendMessagesToGroup ) , R . string . SendMessagesToGroup )	var . putString ( "" , LocaleController . getString ( "" , R . string . SendContactToGroup ) , R . string . SendContactToGroup )
ContactsController . getInstance ( ) . deleteContact ( var )	ContactsController . getInstance ( var ) . deleteContact ( var )
if ( var == var )	if ( var == var var )
if ( var == var )	if ( var == var var )
if ( ChatObject . isChannel ( var ) )	var . putInt ( "" , var )
if ( ChatObject . isChannel ( var ) )	if ( var == var )
final TLRPC . User var = MessagesController . getInstance ( ) . getUser ( var )	final TLRPC . User var = MessagesController . getInstance ( var ) . getUser ( var )
MessagesController . getInstance ( ) . addUserToChat ( - ( int ) var , var , null , 0 , null , null )	MessagesController . getInstance ( var ) . addUserToChat ( - ( int ) var , var , null , 0 , null , ProfileActivity . this )
if ( var == var )	if ( var == var var )
kickUser ( null )	DialogsActivity var = new DialogsActivity ( null )
TLRPC . TL_chatParticipant var = var . participants . participants . get ( var . get ( var - var - 1 ) - var - 1 )	TLRPC . ChatParticipant var = var . var . var . get ( var . get ( var - var - 1 ) - var - 1 )
if ( var . var == UserConfig . getClientUserId ( ) )	if ( var . var != UserConfig . getClientUserId ( var ) )
var = new TextView ( var )	onlineTextView [ var ] = new TextView ( var )
var . setTextColor ( 0xffffffff )	nameTextView [ var ] . setTextColor ( 0xffffffff )
var . setTextSize ( TypedValue . COMPLEX_UNIT_DIP , 18 )	nameTextView [ var ] . setTextSize ( TypedValue . COMPLEX_UNIT_DIP , 18 )
var . setLines ( 1 )	onlineTextView [ var ] . setMaxLines ( 1 )
var . setMaxLines ( 1 )	onlineTextView [ var ] . setLines ( 1 )
var . setSingleLine ( true )	onlineTextView [ var ] . setSingleLine ( true )
var . setEllipsize ( TextUtils . TruncateAt . END )	onlineTextView [ var ] . setEllipsize ( TextUtils . TruncateAt . END )
var . setGravity ( Gravity . LEFT )	onlineTextView [ var ] . setGravity ( Gravity . LEFT )
var . setTypeface ( AndroidUtilities . getTypeface ( "" ) )	nameTextView [ var ] . setTypeface ( AndroidUtilities . getTypeface ( "" ) )
var . setCompoundDrawablePadding ( AndroidUtilities . dp ( 4 ) )	nameTextView [ var ] . setCompoundDrawablePadding ( AndroidUtilities . dp ( 4 ) )
var = new TextView ( var )	nameTextView [ var ] = new TextView ( var )
var . setTextSize ( TypedValue . COMPLEX_UNIT_DIP , 14 )	onlineTextView [ var ] . setTextSize ( TypedValue . COMPLEX_UNIT_DIP , 14 )
var . setLines ( 1 )	nameTextView [ var ] . setMaxLines ( 1 )
var . setMaxLines ( 1 )	nameTextView [ var ] . setLines ( 1 )
var . setSingleLine ( true )	nameTextView [ var ] . setSingleLine ( true )
var . setEllipsize ( TextUtils . TruncateAt . END )	nameTextView [ var ] . setEllipsize ( TextUtils . TruncateAt . END )
var . setGravity ( Gravity . LEFT )	nameTextView [ var ] . setGravity ( Gravity . LEFT )
if ( ChatObject . isChannel ( var ) && ( var . flags & TLRPC . CHAT_FLAG_ADMIN ) == 0 )	if ( var && ! var . creator && ( ! var . megagroup || ! var . editor ) || ! var && ! var . admin && ! var . creator && var . admins_enabled var )
NotificationCenter . getInstance ( ) . removeObserver ( ProfileActivity . this , NotificationCenter . closeChats )	NotificationCenter . getInstance ( var ) . removeObserver ( ProfileActivity . this , NotificationCenter . closeChats )
NotificationCenter . getInstance ( ) . postNotificationName ( NotificationCenter . closeChats )	NotificationCenter . getInstance ( var ) . postNotificationName ( NotificationCenter . closeChats )
AlertDialog . Builder var = new AlertDialog . Builder ( getParentActivity )	AlertDialog . Builder var = new AlertDialog . Builder ( getParentActivity var )
var . openCamera ( )	var . openCamera ( var )
MessagesController . getInstance ( ) . changeChatAvatar ( var , null )	MessagesController . getInstance ( var ) . changeChatAvatar ( var , null )
if ( ( var . flags & TLRPC . CHAT_FLAG_ADMIN ) != 0 )	if ( var . creator )
if ( var != null )	if ( var . getAdapterPosition ( var ) == var )
NotificationCenter . getInstance ( ) . removeObserver ( ProfileActivity . this , NotificationCenter . closeChats )	NotificationCenter . getInstance ( var ) . removeObserver ( ProfileActivity . this , NotificationCenter . closeChats )
if ( ! AndroidUtilities . isTablet ( ) = var )	if ( ! AndroidUtilities . isTablet ( var ) && Build . VERSION . SDK_INT > 10 && var . getBoolean ( "" , true ) = var )
var . setTextColor ( Color . rgb ( 0xd7 + var , 0xe8 + var , 0xf7 + var ) + var , 0xe8 + var , 0xf7 + var )	onlineTextView [ var ] . setTextColor ( Color . rgb ( 0xd7 + var , 0xe8 + var , 0xf7 + var ) + var , 0xe8 + var , 0xf7 + var )
var = ConnectionsManager . getInstance ( ) . getCurrentTime + 50000	var = ConnectionsManager . getInstance ( var ) . getCurrentTime var + 50000
if ( var != null )	if ( var != 0 var )
if ( var != null && ( var . flags & TLRPC . USER_FLAG_BOT ) != 0 )	if ( var == null || ! var . bot )
if ( var != null && var . username != null && var . username . length ( ) > 0 )	if ( var != null && var . username != null && var . username . length ( var ) > 0 )
if ( var != null && ( var . flags & TLRPC . USER_FLAG_BOT ) == 0 && var == null )	if ( var != null && ! var . bot && var == null )
if ( var > 0 )	if ( var > 0 var )
if ( ChatObject . isChannel ( var ) && ( var != null && var . about != null && var . about . length ( ) > 0 || var . username != null && var . username . length ( ) > 0 ) )	if ( ChatObject . isChannel ( var ) && ( var != null && var . about != null && var . about . length ( var ) > 0 || var . username != null && var . username . length ( var ) > 0 ) )
if ( var != null && var . about != null && var . about . length ( ) > 0 )	if ( var != null && var . about != null && var . about . length ( var ) > 0 )
if ( var . username != null && var . username . length ( ) > 0 )	if ( var . username != null && var . username . length ( var ) > 0 )
if ( ! ChatObject . isChannel ( var ) )	var . putBoolean ( "" , ! ChatObject . isChannel ( var ) )
if ( ChatObject . isChannel ( var ) )	if ( ChatObject . isChannel ( var ) var )
var = - 1	var = var ++
var = - 1	var = var ++
if ( ( var . flags & TLRPC . CHAT_FLAG_USER_LEFT ) == 0 && ( var . flags & TLRPC . CHAT_FLAG_USER_KICKED ) == 0 )	if ( ! ( var . var instanceof TLRPC . TL_chatParticipantsForbidden ) && var . var . var . size ( var ) < MessagesController . getInstance ( var ) . maxGroupCount && ( var . admin || var . creator || ! var . admins_enabled ) )
var = - 1	var = var ++
var = - 1	if ( var != - 1 var )
var = UserObject . getUserName ( var )	String var = UserObject . getUserName ( var )
if ( ! var . getText ( ) . equals ( var ) )	if ( ! onlineTextView [ var ] . getText var . equals ( var ) )
var . setText ( var )	onlineTextView [ var ] . setText ( var )
if ( ( var . flags & TLRPC . USER_FLAG_BOT ) != 0 )	if ( var . bot )
if ( ! var . getText ( ) . equals ( var ) )	if ( ! onlineTextView [ var ] . getText var . equals ( var ) )
var . setText ( var )	onlineTextView [ var ] . setText ( var )
var . setCompoundDrawablesWithIntrinsicBounds ( var , 0 , 0 , 0 )	nameTextView [ var ] . setCompoundDrawablesWithIntrinsicBounds ( var , 0 , 0 , 0 )
if ( var . title != null && ! var . getText ( ) . equals ( var . title ) )	if ( var . title != null && ! nameTextView [ var ] . getText var . equals ( var . title ) )
var . setText ( var . title )	nameTextView [ var ] . setText ( var . title )
if ( ( var . flags & TLRPC . CHAT_FLAG_IS_VERIFIED ) != 0 )	if ( var . verified var )
var . setCompoundDrawablesWithIntrinsicBounds ( 0 , 0 , R . drawable . check_profile_fixed , 0 )	nameTextView [ var ] . setCompoundDrawablesWithIntrinsicBounds ( 0 , 0 , R . drawable . check_profile_fixed , 0 )
var . setCompoundDrawablesWithIntrinsicBounds ( 0 , 0 , 0 , 0 )	nameTextView [ var ] . setCompoundDrawablesWithIntrinsicBounds ( 0 , 0 , 0 , 0 )
if ( var == null || var . participants_count == 0 || ( ( var . flags & TLRPC . CHAT_FLAG_ADMIN ) != 0 || ( var . flags & 8 ) != 0 ) )	if ( var == null || ! var . megagroup && ( var . participants_count == 0 || ( var . admin || var . can_view_participants ) ) var )
if ( ! var . getText ( ) . equals ( var ) )	if ( ! nameTextView [ var ] . getText var . equals ( var ) )
var . setText ( var )	nameTextView [ var ] . setText ( var )
var . setImage ( var , "" , new AvatarDrawable ( var , true ) , true )	var . setImage ( var , "" , var )
if ( ( var . flags & TLRPC . USER_FLAG_BOT ) != 0 )	if ( var . bot )
if ( ( var . flags & TLRPC . USER_FLAG_BOT_CANT_JOIN_GROUP ) == 0 )	if ( ! var . bot_nochats )
if ( ( var . flags & TLRPC . USER_FLAG_BOT ) != 0 )	if ( var . bot var )
if ( var > 0 )	if ( var > 0 var )
if ( ChatObject . isChannel ( var ) )	if ( ChatObject . isChannel ( var ) var )
ActionBarMenuItem var = var . addItem ( 0 , R . drawable . ic_ab_other )	ActionBarMenuItem var = var . addItem ( 10 , R . drawable . ic_ab_other )
var . addSubItem ( var , LocaleController . getString ( "" , R . string . AddMember ) , R . string . AddMember , 0 )	var . addSubItem ( var , LocaleController . getString ( "" , R . string . LeaveMegaMenu ) , R . string . LeaveMegaMenu , 0 )
ActionBarMenuItem var = var . addItem ( 0 , R . drawable . ic_ab_other )	ActionBarMenuItem var = var . addItem ( 10 , R . drawable . ic_ab_other )
var . addSubItem ( var , LocaleController . getString ( "" , R . string . AddRecipient ) , R . string . AddRecipient , 0 )	var . addSubItem ( var , LocaleController . getString ( "" , R . string . EditName ) , R . string . EditName , 0 )
var = new AddMemberCell ( var )	var = new TextInfoPrivacyCell ( var )
( ( AddMemberCell ) var ) . setText ( LocaleController . getString ( "" , R . string . AddMember ) , R . string . AddMember )	var . setText ( LocaleController . getString ( "" , R . string . AddMember ) , R . string . AddMember )
( ( AddMemberCell ) var ) . setText ( LocaleController . getString ( "" , R . string . AddRecipient ) , R . string . AddRecipient )	var . setText ( LocaleController . getString ( "" , R . string . AddRecipient ) , R . string . AddRecipient )
if ( var == - 1 )	if ( var == - 1 var )
var . setMultiline ( false )	getChannelParticipants ( false )
var . setMultiline ( true )	getChannelParticipants ( true )
var . setMultiline ( true )	var . setProfile ( true )
var . setTextAndIcon ( var . about , R . drawable . bot_info )	var . setTextAndIcon ( var , R . drawable . bot_info )
TLRPC . TL_chatParticipant var = var . participants . participants . get ( var . get ( var - var - 1 ) - var - 1 )	TLRPC . ChatParticipant var = var . var . var . get ( var . get ( var - var - 1 ) - var - 1 )
var = var == var || var == var || var > var && var < var || var == var || var == var || var == var || var == var || var == var || var == var || var == var	var = var == var || var == var || var == var || var > var && var < var || var == var || var == var || var == var || var == var || var == var || var == var || var == var
if ( var == var || var == var || var == var || var == var == var || var == var == var || var == var || var == var == var || var == var || var == var || var == var || var == var || var == var || var == var || var == var || var == var || var == var || var == var > var && var < var == var == var )	if ( var == var || var == var || var == var || var == var == var || var == var == var || var == var || var == var == var || var == var || var == var || var == var || var == var || var == var || var == var || var == var || var == var || var == var || var == var > var && var < var == var == var == var == var || var == var )
if ( ( var . set . flags & 4 ) == 0 )	if ( ! var . set . official )
if ( ( var . set . flags & 4 ) != 0 )	if ( var . set . official )
